codigo,prov,dpto,frac,rad,varon,mujer,total
140070101,14,7,1,1,40,28,68
140070102,14,7,1,2,261,233,494
140070103,14,7,1,3,123,96,219
140070104,14,7,1,4,45,32,77
140070105,14,7,1,5,137,131,268
140070106,14,7,1,6,51,32,83
140070107,14,7,1,7,76,59,135
140070108,14,7,1,8,202,155,357
140070110,14,7,1,10,238,209,447
140070111,14,7,1,11,346,302,648
140070112,14,7,1,12,264,242,506
140070113,14,7,1,13,275,274,549
140070201,14,7,2,1,158,147,305
140070202,14,7,2,2,60,49,109
140070203,14,7,2,3,117,122,239
140070204,14,7,2,4,257,227,484
140070205,14,7,2,5,246,237,483
140070206,14,7,2,6,492,539,1031
140070207,14,7,2,7,382,425,807
140070208,14,7,2,8,474,506,980
140070209,14,7,2,9,318,358,676
140070210,14,7,2,10,179,232,411
140070211,14,7,2,11,465,449,914
140070212,14,7,2,12,230,261,491
140070213,14,7,2,13,225,236,461
140070214,14,7,2,14,330,325,655
140070215,14,7,2,15,282,301,583
140070216,14,7,2,16,160,143,303
140070301,14,7,3,1,31,20,51
140070302,14,7,3,2,27,29,56
140070303,14,7,3,3,13,7,20
140070304,14,7,3,4,29,34,63
140070305,14,7,3,5,164,137,301
140070306,14,7,3,6,48,46,94
140070307,14,7,3,7,58,32,90
140070308,14,7,3,8,132,128,260
140070309,14,7,3,9,461,465,926
140070310,14,7,3,10,301,334,635
140070311,14,7,3,11,428,455,883
140070312,14,7,3,12,418,455,873
140070401,14,7,4,1,26,28,54
140070402,14,7,4,2,44,21,65
140070403,14,7,4,3,56,37,93
140070404,14,7,4,4,5,2,7
140070405,14,7,4,5,82,75,157
140070406,14,7,4,6,106,113,219
140070407,14,7,4,7,128,113,241
140070408,14,7,4,8,39,31,70
140070409,14,7,4,9,16,8,24
140070410,14,7,4,10,20,8,28
140070411,14,7,4,11,33,24,57
140070412,14,7,4,12,59,47,106
140070413,14,7,4,13,89,68,157
140070414,14,7,4,14,576,521,1097
140070415,14,7,4,15,97,86,183
140070416,14,7,4,16,202,224,426
140070501,14,7,5,1,331,334,665
140070502,14,7,5,2,178,178,356
140070503,14,7,5,3,244,253,497
140070504,14,7,5,4,267,255,522
140070505,14,7,5,5,241,256,497
140070506,14,7,5,6,434,451,885
140070507,14,7,5,7,334,324,658
140070508,14,7,5,8,307,285,592
140070509,14,7,5,9,335,367,702
140070510,14,7,5,10,454,479,933
140070511,14,7,5,11,379,459,838
140070512,14,7,5,12,402,428,830
140070513,14,7,5,13,365,395,760
140070514,14,7,5,14,283,304,587
140070515,14,7,5,15,328,330,658
140070516,14,7,5,16,200,193,393
140070517,14,7,5,17,525,516,1041
140070518,14,7,5,18,518,463,981
140070601,14,7,6,1,17,15,32
140070602,14,7,6,2,121,128,249
140070603,14,7,6,3,74,63,137
140070604,14,7,6,4,28,31,59
140070605,14,7,6,5,87,85,172
140070606,14,7,6,6,80,94,174
140070607,14,7,6,7,378,391,769
140070608,14,7,6,8,339,348,687
140070609,14,7,6,9,235,261,496
140070610,14,7,6,10,234,225,459
140070611,14,7,6,11,325,376,701
140070612,14,7,6,12,250,241,491
140070613,14,7,6,13,191,211,402
140070614,14,7,6,14,411,393,804
140070615,14,7,6,15,224,193,417
140070616,14,7,6,16,158,169,327
140070701,14,7,7,1,49,33,82
140070702,14,7,7,2,37,31,68
140070703,14,7,7,3,20,12,32
140070704,14,7,7,4,9,8,17
140070705,14,7,7,5,42,42,84
140070706,14,7,7,6,430,443,873
140070707,14,7,7,7,32,18,50
140070708,14,7,7,8,27,18,45
140070709,14,7,7,9,16,10,26
140070710,14,7,7,10,23,10,33
140070711,14,7,7,11,25,14,39
140070712,14,7,7,12,25,21,46
140070713,14,7,7,13,57,36,93
140070714,14,7,7,14,12,4,16
140070715,14,7,7,15,126,102,228
140070716,14,7,7,16,17,17,34
140070717,14,7,7,17,15,10,25
140070718,14,7,7,18,37,24,61
140070719,14,7,7,19,223,267,490
140070720,14,7,7,20,26,28,54
140070801,14,7,8,1,17,14,31
140070802,14,7,8,2,97,89,186
140070803,14,7,8,3,411,453,864
140070804,14,7,8,4,94,106,200
140070805,14,7,8,5,543,579,1122
140070806,14,7,8,6,281,290,571
140070807,14,7,8,7,413,453,866
140070808,14,7,8,8,368,423,791
140070809,14,7,8,9,977,1002,1979
140070810,14,7,8,10,61,42,103
140070811,14,7,8,11,23,18,41
140070812,14,7,8,12,18,18,36
140070813,14,7,8,13,24,20,44
140070814,14,7,8,14,541,521,1062
140070815,14,7,8,15,467,524,991
140070816,14,7,8,16,369,390,759
140070817,14,7,8,17,499,512,1011
140070818,14,7,8,18,398,428,826
140070819,14,7,8,19,59,59,118
140070820,14,7,8,20,316,314,630
140070901,14,7,9,1,44,7,51
140070902,14,7,9,2,38,30,68
140070903,14,7,9,3,28,19,47
140070904,14,7,9,4,347,352,699
140070905,14,7,9,5,26,12,38
140070906,14,7,9,6,39,31,70
140070907,14,7,9,7,26,12,38
140070908,14,7,9,8,160,142,302
140140101,14,14,1,1,306,276,582
140140102,14,14,1,2,639,599,1238
140140103,14,14,1,3,641,642,1283
140140104,14,14,1,4,403,408,811
140140105,14,14,1,5,458,487,945
140140106,14,14,1,6,565,614,1179
140140107,14,14,1,7,362,397,759
140140108,14,14,1,8,379,393,772
140140109,14,14,1,9,725,744,1469
140140110,14,14,1,10,421,454,875
140140111,14,14,1,11,302,377,679
140140112,14,14,1,12,434,516,950
140140113,14,14,1,13,592,606,1198
140140201,14,14,2,1,499,475,974
140140202,14,14,2,2,670,684,1354
140140203,14,14,2,3,527,571,1098
140140204,14,14,2,4,459,503,962
140140205,14,14,2,5,321,402,723
140140206,14,14,2,6,287,277,564
140140207,14,14,2,7,504,577,1081
140140208,14,14,2,8,394,440,834
140140209,14,14,2,9,364,418,782
140140210,14,14,2,10,378,433,811
140140211,14,14,2,11,321,337,658
140140212,14,14,2,12,413,416,829
140140213,14,14,2,13,527,598,1125
140140214,14,14,2,14,552,624,1176
140140215,14,14,2,15,568,654,1222
140140301,14,14,3,1,227,253,480
140140302,14,14,3,2,1038,1094,2132
140140303,14,14,3,3,749,771,1520
140140304,14,14,3,4,732,718,1450
140140305,14,14,3,5,560,569,1129
140140306,14,14,3,6,440,440,880
140140307,14,14,3,7,362,389,751
140140308,14,14,3,8,603,647,1250
140140309,14,14,3,9,719,782,1501
140140310,14,14,3,10,423,483,906
140140311,14,14,3,11,374,425,799
140140312,14,14,3,12,558,655,1213
140140313,14,14,3,13,704,713,1417
140140401,14,14,4,1,807,795,1602
140140402,14,14,4,2,665,637,1302
140140403,14,14,4,3,190,186,376
140140404,14,14,4,4,516,513,1029
140140405,14,14,4,5,951,993,1944
140140406,14,14,4,6,865,871,1736
140140407,14,14,4,7,483,499,982
140140408,14,14,4,8,749,805,1554
140140409,14,14,4,9,516,556,1072
140140410,14,14,4,10,723,774,1497
140140411,14,14,4,11,793,774,1567
140140501,14,14,5,1,449,450,899
140140502,14,14,5,2,722,777,1499
140140503,14,14,5,3,522,550,1072
140140504,14,14,5,4,835,819,1654
140140505,14,14,5,5,818,893,1711
140140506,14,14,5,6,412,434,846
140140507,14,14,5,7,618,605,1223
140140508,14,14,5,8,718,711,1429
140140509,14,14,5,9,451,474,925
140140510,14,14,5,10,689,750,1439
140140511,14,14,5,11,576,606,1182
140140512,14,14,5,12,583,628,1211
140140513,14,14,5,13,670,746,1416
140140514,14,14,5,14,758,779,1537
140140515,14,14,5,15,699,725,1424
140140601,14,14,6,1,411,399,810
140140602,14,14,6,2,81,93,174
140140603,14,14,6,3,119,120,239
140140604,14,14,6,4,449,408,857
140140605,14,14,6,5,493,440,933
140140606,14,14,6,6,450,457,907
140140607,14,14,6,7,824,874,1698
140140608,14,14,6,8,321,303,624
140140609,14,14,6,9,615,615,1230
140140610,14,14,6,10,530,558,1088
140140701,14,14,7,1,651,638,1289
140140702,14,14,7,2,415,428,843
140140703,14,14,7,3,318,331,649
140140704,14,14,7,4,549,535,1084
140140705,14,14,7,5,603,614,1217
140140706,14,14,7,6,18,11,29
140140707,14,14,7,7,458,437,895
140140708,14,14,7,8,652,674,1326
140140709,14,14,7,9,782,742,1524
140140710,14,14,7,10,105,103,208
140140711,14,14,7,11,415,426,841
140140712,14,14,7,12,274,230,504
140140713,14,14,7,13,589,554,1143
140140714,14,14,7,14,678,710,1388
140140715,14,14,7,15,573,571,1144
140140801,14,14,8,1,16,26,42
140140802,14,14,8,2,459,434,893
140140803,14,14,8,3,179,208,387
140140804,14,14,8,4,615,604,1219
140140805,14,14,8,5,828,831,1659
140140806,14,14,8,6,403,481,884
140140807,14,14,8,7,484,500,984
140140808,14,14,8,8,435,441,876
140140809,14,14,8,9,938,958,1896
140140810,14,14,8,10,739,768,1507
140140811,14,14,8,11,706,733,1439
140140812,14,14,8,12,568,464,1032
140140901,14,14,9,1,24,18,42
140140902,14,14,9,2,666,682,1348
140140903,14,14,9,3,626,586,1212
140140904,14,14,9,4,484,498,982
140140905,14,14,9,5,757,797,1554
140140906,14,14,9,6,467,513,980
140140907,14,14,9,7,265,275,540
140140908,14,14,9,8,820,819,1639
140140909,14,14,9,9,693,709,1402
140140910,14,14,9,10,623,692,1315
140140911,14,14,9,11,776,783,1559
140140912,14,14,9,12,1018,1029,2047
140140913,14,14,9,13,625,646,1271
140140914,14,14,9,14,515,542,1057
140140915,14,14,9,15,32,32,64
140141001,14,14,10,1,292,265,557
140141002,14,14,10,2,784,841,1625
140141003,14,14,10,3,301,356,657
140141004,14,14,10,4,339,451,790
140141005,14,14,10,5,330,340,670
140141006,14,14,10,6,527,564,1091
140141007,14,14,10,7,220,269,489
140141008,14,14,10,8,811,810,1621
140141009,14,14,10,9,500,548,1048
140141010,14,14,10,10,559,526,1085
140141011,14,14,10,11,731,804,1535
140141012,14,14,10,12,351,381,732
140141013,14,14,10,13,521,539,1060
140141014,14,14,10,14,318,308,626
140141015,14,14,10,15,421,473,894
140141016,14,14,10,16,508,543,1051
140141017,14,14,10,17,380,389,769
140141018,14,14,10,18,326,332,658
140141101,14,14,11,1,245,208,453
140141102,14,14,11,2,481,466,947
140141103,14,14,11,3,510,492,1002
140141104,14,14,11,4,347,389,736
140141105,14,14,11,5,448,468,916
140141106,14,14,11,6,426,434,860
140141107,14,14,11,7,449,476,925
140141108,14,14,11,8,574,571,1145
140141109,14,14,11,9,807,839,1646
140141110,14,14,11,10,512,570,1082
140141111,14,14,11,11,522,532,1054
140141201,14,14,12,1,506,498,1004
140141202,14,14,12,2,575,614,1189
140141203,14,14,12,3,703,721,1424
140141204,14,14,12,4,767,769,1536
140141205,14,14,12,5,792,869,1661
140141206,14,14,12,6,466,491,957
140141207,14,14,12,7,463,532,995
140141208,14,14,12,8,512,576,1088
140141209,14,14,12,9,548,561,1109
140141301,14,14,13,1,215,230,445
140141302,14,14,13,2,686,668,1354
140141303,14,14,13,3,510,526,1036
140141304,14,14,13,4,642,684,1326
140141305,14,14,13,5,427,443,870
140141306,14,14,13,6,402,395,797
140141307,14,14,13,7,685,722,1407
140141308,14,14,13,8,645,667,1312
140141309,14,14,13,9,959,946,1905
140141310,14,14,13,10,303,337,640
140141401,14,14,14,1,733,763,1496
140141402,14,14,14,2,1134,1096,2230
140141403,14,14,14,3,670,715,1385
140141404,14,14,14,4,367,409,776
140141405,14,14,14,5,443,443,886
140141406,14,14,14,6,671,678,1349
140141407,14,14,14,7,637,709,1346
140141408,14,14,14,8,92,111,203
140141501,14,14,15,1,388,386,774
140141502,14,14,15,2,389,438,827
140141503,14,14,15,3,315,350,665
140141504,14,14,15,4,481,558,1039
140141505,14,14,15,5,491,562,1053
140141506,14,14,15,6,777,810,1587
140141507,14,14,15,7,312,358,670
140141508,14,14,15,8,463,497,960
140141509,14,14,15,9,606,718,1324
140141510,14,14,15,10,617,655,1272
140141511,14,14,15,11,704,753,1457
140141512,14,14,15,12,289,338,627
140141513,14,14,15,13,1016,1046,2062
140141514,14,14,15,14,598,646,1244
140141515,14,14,15,15,542,494,1036
140141516,14,14,15,16,330,320,650
140141517,14,14,15,17,604,609,1213
140141518,14,14,15,18,451,511,962
140141519,14,14,15,19,515,495,1010
140141520,14,14,15,20,793,751,1544
140141601,14,14,16,1,714,719,1433
140141602,14,14,16,2,922,934,1856
140141603,14,14,16,3,996,998,1994
140141604,14,14,16,4,409,369,778
140141605,14,14,16,5,487,554,1041
140141606,14,14,16,6,656,680,1336
140141607,14,14,16,7,612,671,1283
140141608,14,14,16,8,333,393,726
140141609,14,14,16,9,489,487,976
140141610,14,14,16,10,493,524,1017
140141611,14,14,16,11,713,710,1423
140141612,14,14,16,12,537,541,1078
140141613,14,14,16,13,547,513,1060
140141614,14,14,16,14,517,526,1043
140141615,14,14,16,15,435,449,884
140141616,14,14,16,16,939,887,1826
140141617,14,14,16,17,624,578,1202
140141618,14,14,16,18,902,926,1828
140141701,14,14,17,1,709,704,1413
140141702,14,14,17,2,590,568,1158
140141703,14,14,17,3,578,612,1190
140141704,14,14,17,4,678,732,1410
140141705,14,14,17,5,569,582,1151
140141706,14,14,17,6,824,805,1629
140141707,14,14,17,7,483,490,973
140141708,14,14,17,8,603,638,1241
140141709,14,14,17,9,414,466,880
140141710,14,14,17,10,590,616,1206
140141711,14,14,17,11,582,637,1219
140141712,14,14,17,12,499,519,1018
140141713,14,14,17,13,847,902,1749
140141714,14,14,17,14,459,498,957
140141715,14,14,17,15,670,740,1410
140141716,14,14,17,16,980,962,1942
140141717,14,14,17,17,851,885,1736
140141718,14,14,17,18,652,689,1341
140141719,14,14,17,19,531,527,1058
140141720,14,14,17,20,311,344,655
140141721,14,14,17,21,644,654,1298
140141801,14,14,18,1,788,807,1595
140141802,14,14,18,2,540,569,1109
140141803,14,14,18,3,518,540,1058
140141804,14,14,18,4,496,532,1028
140141805,14,14,18,5,861,846,1707
140141806,14,14,18,6,450,496,946
140141807,14,14,18,7,422,470,892
140141808,14,14,18,8,834,864,1698
140141809,14,14,18,9,624,641,1265
140141810,14,14,18,10,351,391,742
140141811,14,14,18,11,585,663,1248
140141812,14,14,18,12,558,602,1160
140141813,14,14,18,13,527,555,1082
140141814,14,14,18,14,701,705,1406
140141815,14,14,18,15,504,549,1053
140141816,14,14,18,16,928,937,1865
140141817,14,14,18,17,643,614,1257
140141818,14,14,18,18,732,688,1420
140141901,14,14,19,1,594,690,1284
140141902,14,14,19,2,389,404,793
140141903,14,14,19,3,536,535,1071
140141904,14,14,19,4,573,604,1177
140141905,14,14,19,5,571,551,1122
140141906,14,14,19,6,768,814,1582
140141907,14,14,19,7,847,888,1735
140141908,14,14,19,8,899,931,1830
140141909,14,14,19,9,692,687,1379
140141910,14,14,19,10,441,485,926
140141911,14,14,19,11,543,588,1131
140141912,14,14,19,12,541,494,1035
140141913,14,14,19,13,697,762,1459
140141914,14,14,19,14,771,794,1565
140141915,14,14,19,15,777,853,1630
140141916,14,14,19,16,686,783,1469
140141917,14,14,19,17,401,424,825
140141918,14,14,19,18,404,425,829
140141919,14,14,19,19,475,484,959
140142001,14,14,20,1,488,529,1017
140142002,14,14,20,2,370,392,762
140142003,14,14,20,3,411,467,878
140142004,14,14,20,4,551,561,1112
140142005,14,14,20,5,610,713,1323
140142006,14,14,20,6,430,448,878
140142007,14,14,20,7,391,446,837
140142008,14,14,20,8,382,399,781
140142009,14,14,20,9,333,368,701
140142010,14,14,20,10,453,461,914
140142011,14,14,20,11,355,394,749
140142012,14,14,20,12,483,505,988
140142013,14,14,20,13,476,527,1003
140142014,14,14,20,14,538,581,1119
140142015,14,14,20,15,285,326,611
140142016,14,14,20,16,644,687,1331
140142101,14,14,21,1,470,497,967
140142102,14,14,21,2,543,576,1119
140142103,14,14,21,3,493,469,962
140142104,14,14,21,4,762,810,1572
140142105,14,14,21,5,722,457,1179
140142201,14,14,22,1,353,348,701
140142202,14,14,22,2,573,646,1219
140142203,14,14,22,3,353,379,732
140142204,14,14,22,4,399,396,795
140142205,14,14,22,5,254,306,560
140142206,14,14,22,6,715,742,1457
140142207,14,14,22,7,368,400,768
140142208,14,14,22,8,602,621,1223
140142209,14,14,22,9,351,440,791
140142210,14,14,22,10,504,550,1054
140142211,14,14,22,11,534,565,1099
140142212,14,14,22,12,550,547,1097
140142213,14,14,22,13,4,3,7
140142214,14,14,22,14,404,419,823
140142215,14,14,22,15,475,559,1034
140142216,14,14,22,16,425,468,893
140142217,14,14,22,17,600,581,1181
140142218,14,14,22,18,710,815,1525
140142301,14,14,23,1,395,450,845
140142302,14,14,23,2,452,539,991
140142303,14,14,23,3,328,373,701
140142304,14,14,23,4,236,284,520
140142305,14,14,23,5,249,287,536
140142306,14,14,23,6,344,418,762
140142307,14,14,23,7,396,424,820
140142308,14,14,23,8,614,660,1274
140142309,14,14,23,9,291,310,601
140142310,14,14,23,10,431,404,835
140142311,14,14,23,11,361,379,740
140142312,14,14,23,12,414,460,874
140142313,14,14,23,13,846,931,1777
140142314,14,14,23,14,433,438,871
140142315,14,14,23,15,417,444,861
140142316,14,14,23,16,312,322,634
140142401,14,14,24,1,537,578,1115
140142402,14,14,24,2,455,516,971
140142403,14,14,24,3,397,448,845
140142404,14,14,24,4,630,657,1287
140142405,14,14,24,5,398,427,825
140142406,14,14,24,6,402,521,923
140142407,14,14,24,7,335,391,726
140142408,14,14,24,8,337,414,751
140142409,14,14,24,9,420,502,922
140142410,14,14,24,10,190,268,458
140142411,14,14,24,11,301,339,640
140142412,14,14,24,12,225,296,521
140142413,14,14,24,13,276,355,631
140142414,14,14,24,14,256,342,598
140142501,14,14,25,1,206,278,484
140142502,14,14,25,2,292,333,625
140142503,14,14,25,3,127,150,277
140142504,14,14,25,4,557,662,1219
140142505,14,14,25,5,387,441,828
140142506,14,14,25,6,483,563,1046
140142507,14,14,25,7,472,567,1039
140142508,14,14,25,8,256,300,556
140142509,14,14,25,9,352,382,734
140142510,14,14,25,10,301,360,661
140142511,14,14,25,11,357,416,773
140142512,14,14,25,12,298,397,695
140142513,14,14,25,13,321,370,691
140142514,14,14,25,14,293,328,621
140142515,14,14,25,15,468,550,1018
140142516,14,14,25,16,504,536,1040
140142517,14,14,25,17,327,415,742
140142518,14,14,25,18,439,485,924
140142601,14,14,26,1,400,429,829
140142602,14,14,26,2,307,357,664
140142603,14,14,26,3,424,474,898
140142604,14,14,26,4,228,293,521
140142605,14,14,26,5,208,269,477
140142606,14,14,26,6,347,408,755
140142607,14,14,26,7,340,401,741
140142608,14,14,26,8,518,592,1110
140142609,14,14,26,9,354,428,782
140142610,14,14,26,10,280,322,602
140142611,14,14,26,11,600,613,1213
140142612,14,14,26,12,362,443,805
140142613,14,14,26,13,329,335,664
140142614,14,14,26,14,362,433,795
140142615,14,14,26,15,405,475,880
140142616,14,14,26,16,347,439,786
140142701,14,14,27,1,406,489,895
140142702,14,14,27,2,538,569,1107
140142703,14,14,27,3,613,688,1301
140142704,14,14,27,4,450,507,957
140142705,14,14,27,5,288,350,638
140142706,14,14,27,6,394,431,825
140142707,14,14,27,7,408,501,909
140142708,14,14,27,8,445,556,1001
140142709,14,14,27,9,319,402,721
140142710,14,14,27,10,449,487,936
140142711,14,14,27,11,415,448,863
140142712,14,14,27,12,293,356,649
140142801,14,14,28,1,612,655,1267
140142802,14,14,28,2,493,504,997
140142803,14,14,28,3,547,652,1199
140142804,14,14,28,4,636,698,1334
140142805,14,14,28,5,565,628,1193
140142806,14,14,28,6,387,451,838
140142807,14,14,28,7,336,395,731
140142808,14,14,28,8,586,690,1276
140142809,14,14,28,9,478,528,1006
140142810,14,14,28,10,615,648,1263
140142811,14,14,28,11,510,560,1070
140142812,14,14,28,12,418,511,929
140142813,14,14,28,13,781,816,1597
140142814,14,14,28,14,863,872,1735
140142815,14,14,28,15,431,504,935
140142816,14,14,28,16,927,949,1876
140142901,14,14,29,1,572,582,1154
140142902,14,14,29,2,505,523,1028
140142903,14,14,29,3,587,637,1224
140142904,14,14,29,4,626,645,1271
140142905,14,14,29,5,606,681,1287
140142906,14,14,29,6,480,612,1092
140142907,14,14,29,7,319,382,701
140142908,14,14,29,8,403,473,876
140142909,14,14,29,9,600,621,1221
140142910,14,14,29,10,535,560,1095
140142911,14,14,29,11,403,435,838
140142912,14,14,29,12,526,571,1097
140142913,14,14,29,13,380,417,797
140142914,14,14,29,14,440,532,972
140142915,14,14,29,15,636,685,1321
140142916,14,14,29,16,454,558,1012
140142917,14,14,29,17,512,610,1122
140142918,14,14,29,18,458,462,920
140142919,14,14,29,19,417,461,878
140143001,14,14,30,1,404,431,835
140143002,14,14,30,2,660,759,1419
140143003,14,14,30,3,498,517,1015
140143004,14,14,30,4,701,754,1455
140143005,14,14,30,5,505,437,942
140143006,14,14,30,6,646,593,1239
140143007,14,14,30,7,353,344,697
140143008,14,14,30,8,628,675,1303
140143009,14,14,30,9,709,728,1437
140143010,14,14,30,10,550,591,1141
140143011,14,14,30,11,466,552,1018
140143012,14,14,30,12,593,628,1221
140143013,14,14,30,13,554,554,1108
140143014,14,14,30,14,559,631,1190
140143015,14,14,30,15,500,548,1048
140143101,14,14,31,1,591,604,1195
140143102,14,14,31,2,978,971,1949
140143103,14,14,31,3,800,862,1662
140143104,14,14,31,4,608,596,1204
140143105,14,14,31,5,671,745,1416
140143106,14,14,31,6,532,545,1077
140143107,14,14,31,7,724,780,1504
140143108,14,14,31,8,558,604,1162
140143109,14,14,31,9,843,886,1729
140143110,14,14,31,10,495,461,956
140143111,14,14,31,11,462,534,996
140143112,14,14,31,12,684,735,1419
140143113,14,14,31,13,465,506,971
140143114,14,14,31,14,435,497,932
140143115,14,14,31,15,411,454,865
140143116,14,14,31,16,626,652,1278
140143201,14,14,32,1,379,436,815
140143202,14,14,32,2,656,783,1439
140143203,14,14,32,3,372,407,779
140143204,14,14,32,4,396,408,804
140143205,14,14,32,5,562,631,1193
140143206,14,14,32,6,518,594,1112
140143207,14,14,32,7,581,652,1233
140143208,14,14,32,8,598,590,1188
140143209,14,14,32,9,407,434,841
140143210,14,14,32,10,611,738,1349
140143211,14,14,32,11,510,529,1039
140143212,14,14,32,12,430,469,899
140143213,14,14,32,13,487,519,1006
140143301,14,14,33,1,453,512,965
140143302,14,14,33,2,368,427,795
140143303,14,14,33,3,479,524,1003
140143304,14,14,33,4,389,421,810
140143305,14,14,33,5,339,385,724
140143306,14,14,33,6,360,378,738
140143307,14,14,33,7,564,587,1151
140143308,14,14,33,8,683,676,1359
140143309,14,14,33,9,393,442,835
140143310,14,14,33,10,376,452,828
140143311,14,14,33,11,416,480,896
140143312,14,14,33,12,442,463,905
140143313,14,14,33,13,447,513,960
140143314,14,14,33,14,402,465,867
140143315,14,14,33,15,386,464,850
140143316,14,14,33,16,335,357,692
140143317,14,14,33,17,516,570,1086
140143318,14,14,33,18,598,672,1270
140143319,14,14,33,19,493,543,1036
140143320,14,14,33,20,362,383,745
140143401,14,14,34,1,390,429,819
140143402,14,14,34,2,480,565,1045
140143403,14,14,34,3,378,424,802
140143404,14,14,34,4,205,200,405
140143405,14,14,34,5,280,302,582
140143406,14,14,34,6,281,325,606
140143407,14,14,34,7,345,365,710
140143408,14,14,34,8,368,363,731
140143409,14,14,34,9,375,403,778
140143410,14,14,34,10,315,363,678
140143411,14,14,34,11,304,320,624
140143412,14,14,34,12,375,424,799
140143413,14,14,34,13,337,413,750
140143414,14,14,34,14,339,396,735
140143415,14,14,34,15,314,374,688
140143416,14,14,34,16,382,399,781
140143417,14,14,34,17,281,322,603
140143418,14,14,34,18,530,658,1188
140143419,14,14,34,19,296,343,639
140143501,14,14,35,1,454,454,908
140143502,14,14,35,2,705,788,1493
140143503,14,14,35,3,332,359,691
140143504,14,14,35,4,632,700,1332
140143505,14,14,35,5,350,343,693
140143506,14,14,35,6,1651,1622,3273
140143507,14,14,35,7,579,669,1248
140143508,14,14,35,8,470,523,993
140143509,14,14,35,9,388,429,817
140143510,14,14,35,10,327,386,713
140143511,14,14,35,11,538,575,1113
140143512,14,14,35,12,472,570,1042
140143513,14,14,35,13,451,483,934
140143514,14,14,35,14,586,667,1253
140143601,14,14,36,1,353,399,752
140143602,14,14,36,2,347,388,735
140143603,14,14,36,3,556,622,1178
140143604,14,14,36,4,462,530,992
140143605,14,14,36,5,447,549,996
140143606,14,14,36,6,374,424,798
140143607,14,14,36,7,358,397,755
140143608,14,14,36,8,375,452,827
140143609,14,14,36,9,308,345,653
140143610,14,14,36,10,282,338,620
140143611,14,14,36,11,377,433,810
140143612,14,14,36,12,323,419,742
140143613,14,14,36,13,331,379,710
140143614,14,14,36,14,318,344,662
140143701,14,14,37,1,657,750,1407
140143702,14,14,37,2,316,332,648
140143703,14,14,37,3,392,423,815
140143704,14,14,37,4,403,491,894
140143705,14,14,37,5,440,447,887
140143706,14,14,37,6,538,574,1112
140143707,14,14,37,7,516,561,1077
140143708,14,14,37,8,500,553,1053
140143709,14,14,37,9,317,367,684
140143710,14,14,37,10,383,410,793
140143711,14,14,37,11,633,739,1372
140143712,14,14,37,12,392,473,865
140143713,14,14,37,13,309,394,703
140143714,14,14,37,14,289,344,633
140143715,14,14,37,15,306,339,645
140143716,14,14,37,16,263,302,565
140143717,14,14,37,17,299,307,606
140143718,14,14,37,18,211,257,468
140143719,14,14,37,19,283,315,598
140143720,14,14,37,20,283,307,590
140143721,14,14,37,21,242,274,516
140143801,14,14,38,1,544,654,1198
140143802,14,14,38,2,463,553,1016
140143803,14,14,38,3,442,539,981
140143804,14,14,38,4,424,474,898
140143805,14,14,38,5,323,394,717
140143806,14,14,38,6,342,381,723
140143807,14,14,38,7,330,384,714
140143808,14,14,38,8,568,632,1200
140143809,14,14,38,9,336,399,735
140143810,14,14,38,10,367,471,838
140143811,14,14,38,11,308,452,760
140143812,14,14,38,12,350,390,740
140143813,14,14,38,13,385,435,820
140143814,14,14,38,14,353,388,741
140143815,14,14,38,15,301,379,680
140143816,14,14,38,16,303,340,643
140143901,14,14,39,1,265,277,542
140143902,14,14,39,2,509,599,1108
140143903,14,14,39,3,425,531,956
140143904,14,14,39,4,280,323,603
140143905,14,14,39,5,276,307,583
140143906,14,14,39,6,298,344,642
140143907,14,14,39,7,342,370,712
140143908,14,14,39,8,300,348,648
140143909,14,14,39,9,334,414,748
140143910,14,14,39,10,248,304,552
140143911,14,14,39,11,235,313,548
140143912,14,14,39,12,384,428,812
140143913,14,14,39,13,258,293,551
140144001,14,14,40,1,307,348,655
140144002,14,14,40,2,291,343,634
140144003,14,14,40,3,331,379,710
140144004,14,14,40,4,297,320,617
140144005,14,14,40,5,230,245,475
140144006,14,14,40,6,159,238,397
140144007,14,14,40,7,1120,405,1525
140144008,14,14,40,8,471,513,984
140144009,14,14,40,9,287,309,596
140144010,14,14,40,10,392,480,872
140144011,14,14,40,11,319,369,688
140144012,14,14,40,12,338,363,701
140144101,14,14,41,1,309,366,675
140144102,14,14,41,2,253,294,547
140144103,14,14,41,3,420,506,926
140144104,14,14,41,4,260,273,533
140144105,14,14,41,5,240,320,560
140144106,14,14,41,6,314,383,697
140144107,14,14,41,7,280,359,639
140144108,14,14,41,8,208,248,456
140144109,14,14,41,9,299,320,619
140144110,14,14,41,10,357,428,785
140144111,14,14,41,11,279,353,632
140144112,14,14,41,12,401,477,878
140144113,14,14,41,13,366,454,820
140144114,14,14,41,14,404,484,888
140144115,14,14,41,15,334,385,719
140144116,14,14,41,16,271,331,602
140144117,14,14,41,17,381,457,838
140144118,14,14,41,18,272,328,600
140144119,14,14,41,19,335,346,681
140144201,14,14,42,1,290,376,666
140144202,14,14,42,2,188,232,420
140144203,14,14,42,3,179,233,412
140144204,14,14,42,4,250,297,547
140144205,14,14,42,5,264,349,613
140144206,14,14,42,6,313,373,686
140144207,14,14,42,7,387,472,859
140144208,14,14,42,8,562,614,1176
140144209,14,14,42,9,251,289,540
140144210,14,14,42,10,295,318,613
140144211,14,14,42,11,372,371,743
140144212,14,14,42,12,369,457,826
140144213,14,14,42,13,318,397,715
140144214,14,14,42,14,449,519,968
140144215,14,14,42,15,313,305,618
140144216,14,14,42,16,510,548,1058
140144217,14,14,42,17,339,394,733
140144218,14,14,42,18,533,547,1080
140144219,14,14,42,19,556,634,1190
140144220,14,14,42,20,519,554,1073
140144301,14,14,43,1,529,555,1084
140144302,14,14,43,2,797,821,1618
140144303,14,14,43,3,642,647,1289
140144304,14,14,43,4,714,742,1456
140144305,14,14,43,5,332,346,678
140144306,14,14,43,6,781,872,1653
140144307,14,14,43,7,587,615,1202
140144308,14,14,43,8,757,738,1495
140144309,14,14,43,9,701,686,1387
140144310,14,14,43,10,377,397,774
140144311,14,14,43,11,426,481,907
140144401,14,14,44,1,559,609,1168
140144402,14,14,44,2,464,456,920
140144403,14,14,44,3,483,569,1052
140144404,14,14,44,4,287,340,627
140144405,14,14,44,5,353,367,720
140144406,14,14,44,6,764,862,1626
140144407,14,14,44,7,540,591,1131
140144408,14,14,44,8,292,326,618
140144409,14,14,44,9,525,572,1097
140144410,14,14,44,10,395,431,826
140144411,14,14,44,11,715,793,1508
140144501,14,14,45,1,705,686,1391
140144502,14,14,45,2,944,947,1891
140144503,14,14,45,3,443,460,903
140144504,14,14,45,4,508,563,1071
140144505,14,14,45,5,477,497,974
140144506,14,14,45,6,361,387,748
140144507,14,14,45,7,520,588,1108
140144508,14,14,45,8,413,465,878
140144509,14,14,45,9,549,578,1127
140144510,14,14,45,10,659,689,1348
140144511,14,14,45,11,453,514,967
140144512,14,14,45,12,436,479,915
140144513,14,14,45,13,256,325,581
140144601,14,14,46,1,484,505,989
140144602,14,14,46,2,612,643,1255
140144603,14,14,46,3,458,520,978
140144604,14,14,46,4,361,374,735
140144605,14,14,46,5,403,440,843
140144606,14,14,46,6,432,499,931
140144607,14,14,46,7,383,463,846
140144608,14,14,46,8,342,431,773
140144609,14,14,46,9,524,578,1102
140144610,14,14,46,10,555,597,1152
140144611,14,14,46,11,656,665,1321
140144612,14,14,46,12,423,531,954
140144613,14,14,46,13,228,237,465
140144614,14,14,46,14,580,602,1182
140144615,14,14,46,15,466,527,993
140144616,14,14,46,16,499,527,1026
140144701,14,14,47,1,217,236,453
140144702,14,14,47,2,279,290,569
140144703,14,14,47,3,391,498,889
140144704,14,14,47,4,195,214,409
140144705,14,14,47,5,221,256,477
140144706,14,14,47,6,276,333,609
140144707,14,14,47,7,412,471,883
140144708,14,14,47,8,432,460,892
140144709,14,14,47,9,246,294,540
140144710,14,14,47,10,222,266,488
140144711,14,14,47,11,347,389,736
140144712,14,14,47,12,439,613,1052
140144801,14,14,48,1,159,214,373
140144802,14,14,48,2,255,312,567
140144803,14,14,48,3,280,313,593
140144804,14,14,48,4,228,291,519
140144805,14,14,48,5,260,330,590
140144806,14,14,48,6,281,284,565
140144807,14,14,48,7,339,404,743
140144808,14,14,48,8,245,301,546
140144809,14,14,48,9,197,229,426
140144810,14,14,48,10,399,457,856
140144811,14,14,48,11,257,317,574
140144812,14,14,48,12,253,309,562
140144813,14,14,48,13,294,331,625
140144814,14,14,48,14,311,342,653
140144815,14,14,48,15,472,464,936
140144816,14,14,48,16,325,322,647
140144901,14,14,49,1,211,227,438
140144902,14,14,49,2,208,240,448
140144903,14,14,49,3,208,243,451
140144904,14,14,49,4,253,305,558
140144905,14,14,49,5,258,329,587
140144906,14,14,49,6,204,222,426
140144907,14,14,49,7,515,539,1054
140144908,14,14,49,8,432,471,903
140144909,14,14,49,9,293,384,677
140144910,14,14,49,10,157,151,308
140144911,14,14,49,11,136,153,289
140144912,14,14,49,12,200,237,437
140144913,14,14,49,13,332,405,737
140144914,14,14,49,14,241,300,541
140144915,14,14,49,15,258,324,582
140144916,14,14,49,16,342,365,707
140144917,14,14,49,17,116,149,265
140144918,14,14,49,18,139,162,301
140144919,14,14,49,19,176,248,424
140144920,14,14,49,20,197,223,420
140144921,14,14,49,21,272,329,601
140145001,14,14,50,1,357,394,751
140145002,14,14,50,2,434,464,898
140145003,14,14,50,3,294,314,608
140145004,14,14,50,4,326,385,711
140145005,14,14,50,5,340,433,773
140145006,14,14,50,6,275,308,583
140145007,14,14,50,7,316,394,710
140145008,14,14,50,8,294,393,687
140145009,14,14,50,9,376,511,887
140145010,14,14,50,10,332,397,729
140145011,14,14,50,11,314,372,686
140145012,14,14,50,12,336,393,729
140145013,14,14,50,13,254,293,547
140145014,14,14,50,14,287,353,640
140145015,14,14,50,15,354,414,768
140145101,14,14,51,1,367,405,772
140145102,14,14,51,2,353,372,725
140145103,14,14,51,3,279,307,586
140145104,14,14,51,4,408,487,895
140145105,14,14,51,5,352,413,765
140145106,14,14,51,6,484,554,1038
140145107,14,14,51,7,501,568,1069
140145108,14,14,51,8,401,479,880
140145109,14,14,51,9,478,541,1019
140145110,14,14,51,10,367,423,790
140145111,14,14,51,11,388,414,802
140145112,14,14,51,12,518,597,1115
140145113,14,14,51,13,484,504,988
140145114,14,14,51,14,438,478,916
140145115,14,14,51,15,387,409,796
140145116,14,14,51,16,288,298,586
140145117,14,14,51,17,639,721,1360
140145118,14,14,51,18,425,471,896
140145119,14,14,51,19,637,646,1283
140145120,14,14,51,20,1023,1041,2064
140145121,14,14,51,21,461,528,989
140145201,14,14,52,1,250,327,577
140145202,14,14,52,2,448,563,1011
140145203,14,14,52,3,333,398,731
140145204,14,14,52,4,790,787,1577
140145205,14,14,52,5,210,246,456
140145206,14,14,52,6,234,293,527
140145207,14,14,52,7,291,373,664
140145208,14,14,52,8,273,359,632
140145209,14,14,52,9,267,277,544
140145210,14,14,52,10,263,296,559
140145211,14,14,52,11,259,305,564
140145212,14,14,52,12,561,595,1156
140145213,14,14,52,13,380,432,812
140145214,14,14,52,14,334,381,715
140145215,14,14,52,15,351,355,706
140145216,14,14,52,16,438,470,908
140145217,14,14,52,17,471,444,915
140145218,14,14,52,18,675,692,1367
140145219,14,14,52,19,559,582,1141
140145301,14,14,53,1,316,454,770
140145302,14,14,53,2,304,385,689
140145303,14,14,53,3,173,233,406
140145304,14,14,53,4,217,259,476
140145305,14,14,53,5,209,258,467
140145306,14,14,53,6,265,355,620
140145307,14,14,53,7,268,328,596
140145308,14,14,53,8,429,492,921
140145309,14,14,53,9,283,360,643
140145310,14,14,53,10,302,412,714
140145311,14,14,53,11,303,360,663
140145312,14,14,53,12,259,337,596
140145313,14,14,53,13,212,285,497
140145314,14,14,53,14,287,285,572
140145315,14,14,53,15,300,410,710
140145316,14,14,53,16,227,247,474
140145317,14,14,53,17,236,285,521
140145318,14,14,53,18,275,304,579
140145319,14,14,53,19,318,316,634
140145320,14,14,53,20,182,212,394
140145401,14,14,54,1,222,218,440
140145402,14,14,54,2,223,237,460
140145403,14,14,54,3,243,235,478
140145404,14,14,54,4,198,249,447
140145405,14,14,54,5,171,183,354
140145406,14,14,54,6,270,325,595
140145407,14,14,54,7,120,161,281
140145408,14,14,54,8,163,216,379
140145409,14,14,54,9,291,331,622
140145410,14,14,54,10,243,274,517
140145411,14,14,54,11,139,129,268
140145412,14,14,54,12,241,248,489
140145413,14,14,54,13,294,428,722
140145414,14,14,54,14,192,252,444
140145415,14,14,54,15,188,235,423
140145416,14,14,54,16,156,205,361
140145501,14,14,55,1,256,296,552
140145502,14,14,55,2,244,216,460
140145503,14,14,55,3,123,125,248
140145504,14,14,55,4,104,127,231
140145505,14,14,55,5,162,151,313
140145506,14,14,55,6,83,108,191
140145507,14,14,55,7,115,163,278
140145508,14,14,55,8,46,68,114
140145509,14,14,55,9,135,143,278
140145510,14,14,55,10,127,158,285
140145511,14,14,55,11,196,231,427
140145512,14,14,55,12,139,178,317
140145513,14,14,55,13,180,218,398
140145514,14,14,55,14,141,186,327
140145515,14,14,55,15,65,70,135
140145516,14,14,55,16,185,204,389
140145517,14,14,55,17,252,339,591
140145518,14,14,55,18,160,157,317
140145519,14,14,55,19,248,281,529
140145601,14,14,56,1,190,221,411
140145602,14,14,56,2,238,342,580
140145603,14,14,56,3,234,264,498
140145604,14,14,56,4,173,177,350
140145605,14,14,56,5,186,206,392
140145606,14,14,56,6,122,189,311
140145607,14,14,56,7,109,149,258
140145608,14,14,56,8,123,125,248
140145609,14,14,56,9,130,170,300
140145610,14,14,56,10,73,91,164
140145611,14,14,56,11,271,272,543
140145612,14,14,56,12,94,107,201
140145613,14,14,56,13,141,149,290
140145614,14,14,56,14,97,111,208
140145615,14,14,56,15,110,157,267
140145616,14,14,56,16,114,176,290
140145617,14,14,56,17,151,222,373
140145618,14,14,56,18,188,282,470
140145619,14,14,56,19,138,174,312
140145701,14,14,57,1,294,447,741
140145702,14,14,57,2,183,258,441
140145703,14,14,57,3,190,282,472
140145704,14,14,57,4,283,419,702
140145705,14,14,57,5,154,199,353
140145706,14,14,57,6,73,126,199
140145707,14,14,57,7,119,185,304
140145708,14,14,57,8,57,86,143
140145709,14,14,57,9,105,168,273
140145710,14,14,57,10,109,168,277
140145711,14,14,57,11,143,192,335
140145712,14,14,57,12,101,143,244
140145713,14,14,57,13,176,251,427
140145714,14,14,57,14,177,262,439
140145715,14,14,57,15,232,305,537
140145716,14,14,57,16,74,98,172
140145801,14,14,58,1,115,151,266
140145802,14,14,58,2,265,339,604
140145803,14,14,58,3,154,199,353
140145804,14,14,58,4,185,249,434
140145805,14,14,58,5,265,327,592
140145806,14,14,58,6,272,377,649
140145807,14,14,58,7,165,232,397
140145808,14,14,58,8,240,289,529
140145809,14,14,58,9,223,285,508
140145810,14,14,58,10,104,148,252
140145811,14,14,58,11,264,321,585
140145812,14,14,58,12,205,271,476
140145813,14,14,58,13,92,103,195
140145901,14,14,59,1,438,504,942
140145902,14,14,59,2,153,159,312
140145903,14,14,59,3,260,321,581
140145904,14,14,59,4,261,310,571
140145905,14,14,59,5,241,279,520
140145906,14,14,59,6,199,250,449
140145907,14,14,59,7,190,271,461
140145908,14,14,59,8,119,146,265
140145909,14,14,59,9,214,241,455
140145910,14,14,59,10,203,216,419
140145911,14,14,59,11,184,228,412
140145912,14,14,59,12,388,470,858
140146001,14,14,60,1,389,445,834
140146002,14,14,60,2,318,373,691
140146003,14,14,60,3,264,319,583
140146004,14,14,60,4,389,431,820
140146005,14,14,60,5,427,491,918
140146006,14,14,60,6,337,368,705
140146007,14,14,60,7,274,312,586
140146008,14,14,60,8,192,250,442
140146009,14,14,60,9,305,331,636
140146010,14,14,60,10,258,302,560
140146011,14,14,60,11,448,552,1000
140146012,14,14,60,12,178,228,406
140146013,14,14,60,13,249,305,554
140146014,14,14,60,14,428,532,960
140146015,14,14,60,15,418,471,889
140146016,14,14,60,16,343,422,765
140146017,14,14,60,17,485,535,1020
140146018,14,14,60,18,384,461,845
140146101,14,14,61,1,590,602,1192
140146102,14,14,61,2,528,533,1061
140146103,14,14,61,3,499,491,990
140146104,14,14,61,4,468,447,915
140146105,14,14,61,5,682,619,1301
140146106,14,14,61,6,417,447,864
140146107,14,14,61,7,571,550,1121
140146108,14,14,61,8,562,564,1126
140146109,14,14,61,9,409,446,855
140146110,14,14,61,10,407,459,866
140146111,14,14,61,11,564,541,1105
140146112,14,14,61,12,917,932,1849
140146113,14,14,61,13,801,810,1611
140146114,14,14,61,14,480,514,994
140146115,14,14,61,15,697,684,1381
140146201,14,14,62,1,422,489,911
140146202,14,14,62,2,371,431,802
140146203,14,14,62,3,400,438,838
140146204,14,14,62,4,315,382,697
140146205,14,14,62,5,328,357,685
140146206,14,14,62,6,421,448,869
140146207,14,14,62,7,431,444,875
140146208,14,14,62,8,449,454,903
140146209,14,14,62,9,475,526,1001
140146210,14,14,62,10,474,567,1041
140146211,14,14,62,11,871,842,1713
140146212,14,14,62,12,590,630,1220
140146213,14,14,62,13,434,507,941
140146301,14,14,63,1,299,337,636
140146302,14,14,63,2,288,369,657
140146303,14,14,63,3,291,305,596
140146304,14,14,63,4,330,410,740
140146305,14,14,63,5,501,587,1088
140146306,14,14,63,6,465,485,950
140146307,14,14,63,7,375,441,816
140146308,14,14,63,8,419,493,912
140146309,14,14,63,9,428,468,896
140146310,14,14,63,10,325,362,687
140146311,14,14,63,11,307,328,635
140146312,14,14,63,12,257,298,555
140146313,14,14,63,13,325,390,715
140146401,14,14,64,1,286,315,601
140146402,14,14,64,2,469,533,1002
140146403,14,14,64,3,278,363,641
140146404,14,14,64,4,314,400,714
140146405,14,14,64,5,308,322,630
140146406,14,14,64,6,222,284,506
140146407,14,14,64,7,471,506,977
140146408,14,14,64,8,394,484,878
140146409,14,14,64,9,449,522,971
140146410,14,14,64,10,519,586,1105
140146411,14,14,64,11,444,481,925
140146501,14,14,65,1,257,271,528
140146502,14,14,65,2,340,396,736
140146503,14,14,65,3,172,248,420
140146504,14,14,65,4,162,164,326
140146505,14,14,65,5,290,328,618
140146506,14,14,65,6,333,380,713
140146507,14,14,65,7,255,276,531
140146508,14,14,65,8,162,176,338
140146509,14,14,65,9,238,313,551
140146510,14,14,65,10,233,299,532
140146511,14,14,65,11,466,479,945
140146512,14,14,65,12,398,461,859
140146513,14,14,65,13,300,347,647
140146514,14,14,65,14,633,706,1339
140146515,14,14,65,15,233,282,515
140146516,14,14,65,16,467,469,936
140146601,14,14,66,1,293,372,665
140146602,14,14,66,2,356,428,784
140146603,14,14,66,3,107,149,256
140146604,14,14,66,4,181,243,424
140146605,14,14,66,5,152,191,343
140146606,14,14,66,6,173,227,400
140146607,14,14,66,7,193,255,448
140146608,14,14,66,8,63,80,143
140146609,14,14,66,9,187,230,417
140146610,14,14,66,10,111,143,254
140146611,14,14,66,11,92,137,229
140146612,14,14,66,12,193,240,433
140146613,14,14,66,13,149,164,313
140146614,14,14,66,14,310,392,702
140146701,14,14,67,1,198,278,476
140146702,14,14,67,2,81,109,190
140146703,14,14,67,3,298,401,699
140146704,14,14,67,4,116,224,340
140146705,14,14,67,5,164,233,397
140146706,14,14,67,6,223,354,577
140146707,14,14,67,7,143,175,318
140146708,14,14,67,8,203,256,459
140146709,14,14,67,9,195,274,469
140146710,14,14,67,10,185,217,402
140146711,14,14,67,11,354,486,840
140146801,14,14,68,1,129,183,312
140146802,14,14,68,2,122,157,279
140146803,14,14,68,3,211,294,505
140146804,14,14,68,4,352,440,792
140146805,14,14,68,5,102,120,222
140146806,14,14,68,6,233,299,532
140146807,14,14,68,7,135,177,312
140146808,14,14,68,8,65,90,155
140146809,14,14,68,9,220,270,490
140146810,14,14,68,10,175,209,384
140146811,14,14,68,11,119,139,258
140146812,14,14,68,12,209,229,438
140146813,14,14,68,13,150,145,295
140146814,14,14,68,14,326,373,699
140146901,14,14,69,1,163,231,394
140146902,14,14,69,2,86,126,212
140146903,14,14,69,3,158,261,419
140146904,14,14,69,4,175,237,412
140146905,14,14,69,5,280,290,570
140146906,14,14,69,6,319,314,633
140146907,14,14,69,7,277,294,571
140146908,14,14,69,8,362,388,750
140146909,14,14,69,9,202,199,401
140146910,14,14,69,10,279,281,560
140146911,14,14,69,11,478,492,970
140146912,14,14,69,12,158,189,347
140146913,14,14,69,13,76,66,142
140146914,14,14,69,14,263,314,577
140147001,14,14,70,1,209,312,521
140147002,14,14,70,2,243,270,513
140147003,14,14,70,3,312,334,646
140147004,14,14,70,4,227,331,558
140147005,14,14,70,5,264,319,583
140147006,14,14,70,6,257,357,614
140147007,14,14,70,7,188,266,454
140147008,14,14,70,8,186,314,500
140147009,14,14,70,9,179,234,413
140147010,14,14,70,10,230,313,543
140147011,14,14,70,11,155,235,390
140147101,14,14,71,1,187,217,404
140147102,14,14,71,2,280,384,664
140147103,14,14,71,3,212,326,538
140147104,14,14,71,4,273,375,648
140147105,14,14,71,5,215,253,468
140147106,14,14,71,6,255,367,622
140147107,14,14,71,7,332,414,746
140147108,14,14,71,8,197,256,453
140147109,14,14,71,9,305,456,761
140147110,14,14,71,10,297,394,691
140147111,14,14,71,11,192,293,485
140147201,14,14,72,1,513,621,1134
140147202,14,14,72,2,559,784,1343
140147203,14,14,72,3,495,607,1102
140147204,14,14,72,4,531,529,1060
140147205,14,14,72,5,198,258,456
140147206,14,14,72,6,438,554,992
140147207,14,14,72,7,451,657,1108
140147301,14,14,73,1,347,384,731
140147302,14,14,73,2,314,382,696
140147303,14,14,73,3,290,355,645
140147304,14,14,73,4,309,434,743
140147305,14,14,73,5,306,388,694
140147306,14,14,73,6,363,423,786
140147307,14,14,73,7,307,429,736
140147308,14,14,73,8,316,343,659
140147309,14,14,73,9,441,538,979
140147310,14,14,73,10,261,304,565
140147311,14,14,73,11,273,325,598
140147312,14,14,73,12,267,315,582
140147313,14,14,73,13,326,377,703
140147401,14,14,74,1,584,641,1225
140147402,14,14,74,2,504,510,1014
140147403,14,14,74,3,408,428,836
140147404,14,14,74,4,366,386,752
140147405,14,14,74,5,421,425,846
140147406,14,14,74,6,698,738,1436
140147407,14,14,74,7,483,539,1022
140147408,14,14,74,8,501,567,1068
140147409,14,14,74,9,360,446,806
140147410,14,14,74,10,357,437,794
140147411,14,14,74,11,620,643,1263
140147412,14,14,74,12,499,621,1120
140147413,14,14,74,13,343,453,796
140147414,14,14,74,14,403,460,863
140147415,14,14,74,15,481,522,1003
140147416,14,14,74,16,337,361,698
140147417,14,14,74,17,356,404,760
140147418,14,14,74,18,393,470,863
140147501,14,14,75,1,751,748,1499
140147502,14,14,75,2,498,534,1032
140147503,14,14,75,3,517,525,1042
140147504,14,14,75,4,504,507,1011
140147505,14,14,75,5,527,572,1099
140147506,14,14,75,6,620,686,1306
140147507,14,14,75,7,696,746,1442
140147508,14,14,75,8,523,512,1035
140147509,14,14,75,9,699,664,1363
140147510,14,14,75,10,586,693,1279
140147511,14,14,75,11,600,603,1203
140147512,14,14,75,12,540,588,1128
140147513,14,14,75,13,878,860,1738
140147514,14,14,75,14,877,913,1790
140147515,14,14,75,15,740,787,1527
140147516,14,14,75,16,505,520,1025
140147517,14,14,75,17,531,589,1120
140147518,14,14,75,18,709,707,1416
140147519,14,14,75,19,977,992,1969
140147601,14,14,76,1,690,737,1427
140147602,14,14,76,2,493,538,1031
140147603,14,14,76,3,445,465,910
140147604,14,14,76,4,488,527,1015
140147605,14,14,76,5,498,528,1026
140147606,14,14,76,6,1162,1278,2440
140147607,14,14,76,7,516,520,1036
140147608,14,14,76,8,418,467,885
140147609,14,14,76,9,550,578,1128
140147610,14,14,76,10,456,471,927
140147611,14,14,76,11,439,524,963
140147612,14,14,76,12,609,649,1258
140147613,14,14,76,13,398,425,823
140147614,14,14,76,14,504,546,1050
140147615,14,14,76,15,401,466,867
140147616,14,14,76,16,725,835,1560
140147617,14,14,76,17,730,738,1468
140147701,14,14,77,1,514,589,1103
140147702,14,14,77,2,386,431,817
140147703,14,14,77,3,337,396,733
140147704,14,14,77,4,403,443,846
140147705,14,14,77,5,474,510,984
140147706,14,14,77,6,404,479,883
140147707,14,14,77,7,492,580,1072
140147708,14,14,77,8,422,450,872
140147709,14,14,77,9,363,428,791
140147710,14,14,77,10,425,466,891
140147711,14,14,77,11,322,367,689
140147712,14,14,77,12,442,520,962
140147713,14,14,77,13,673,780,1453
140147714,14,14,77,14,455,492,947
140147715,14,14,77,15,534,583,1117
140147716,14,14,77,16,351,432,783
140147717,14,14,77,17,580,590,1170
140147718,14,14,77,18,338,353,691
140147719,14,14,77,19,603,686,1289
140147720,14,14,77,20,582,633,1215
140147721,14,14,77,21,367,372,739
140147722,14,14,77,22,521,565,1086
140147801,14,14,78,1,521,568,1089
140147802,14,14,78,2,282,322,604
140147803,14,14,78,3,355,419,774
140147804,14,14,78,4,398,455,853
140147805,14,14,78,5,377,425,802
140147806,14,14,78,6,203,246,449
140147807,14,14,78,7,447,466,913
140147808,14,14,78,8,393,442,835
140147809,14,14,78,9,531,569,1100
140147810,14,14,78,10,433,465,898
140147811,14,14,78,11,488,618,1106
140147812,14,14,78,12,407,498,905
140147813,14,14,78,13,276,364,640
140147814,14,14,78,14,573,715,1288
140147815,14,14,78,15,221,272,493
140147816,14,14,78,16,277,317,594
140147901,14,14,79,1,441,491,932
140147902,14,14,79,2,384,444,828
140147903,14,14,79,3,317,396,713
140147904,14,14,79,4,266,343,609
140147905,14,14,79,5,287,353,640
140147906,14,14,79,6,399,490,889
140147907,14,14,79,7,485,521,1006
140147908,14,14,79,8,295,377,672
140147909,14,14,79,9,480,576,1056
140147910,14,14,79,10,375,421,796
140147911,14,14,79,11,487,520,1007
140147912,14,14,79,12,302,340,642
140147913,14,14,79,13,506,477,983
140147914,14,14,79,14,330,377,707
140147915,14,14,79,15,571,638,1209
140147916,14,14,79,16,418,467,885
140147917,14,14,79,17,397,427,824
140147918,14,14,79,18,376,424,800
140147919,14,14,79,19,398,428,826
140147920,14,14,79,20,350,392,742
140148001,14,14,80,1,187,244,431
140148002,14,14,80,2,176,214,390
140148003,14,14,80,3,150,183,333
140148004,14,14,80,4,143,173,316
140148005,14,14,80,5,283,248,531
140148006,14,14,80,6,295,384,679
140148007,14,14,80,7,139,147,286
140148008,14,14,80,8,135,168,303
140148009,14,14,80,9,190,193,383
140148010,14,14,80,10,199,211,410
140148011,14,14,80,11,327,376,703
140148012,14,14,80,12,340,391,731
140148013,14,14,80,13,163,230,393
140148014,14,14,80,14,286,264,550
140148101,14,14,81,1,202,281,483
140148102,14,14,81,2,218,330,548
140148103,14,14,81,3,418,556,974
140148104,14,14,81,4,388,556,944
140148105,14,14,81,5,400,507,907
140148106,14,14,81,6,539,707,1246
140148107,14,14,81,7,184,263,447
140148108,14,14,81,8,183,297,480
140148109,14,14,81,9,189,268,457
140148110,14,14,81,10,204,262,466
140148201,14,14,82,1,257,292,549
140148202,14,14,82,2,312,378,690
140148203,14,14,82,3,244,325,569
140148204,14,14,82,4,417,559,976
140148205,14,14,82,5,154,198,352
140148206,14,14,82,6,129,141,270
140148207,14,14,82,7,271,311,582
140148208,14,14,82,8,549,586,1135
140148209,14,14,82,9,296,303,599
140148210,14,14,82,10,206,182,388
140148211,14,14,82,11,195,194,389
140148301,14,14,83,1,392,458,850
140148302,14,14,83,2,436,513,949
140148303,14,14,83,3,423,466,889
140148304,14,14,83,4,358,372,730
140148305,14,14,83,5,324,337,661
140148306,14,14,83,6,270,346,616
140148307,14,14,83,7,469,521,990
140148308,14,14,83,8,316,339,655
140148309,14,14,83,9,524,416,940
140148310,14,14,83,10,259,224,483
140148311,14,14,83,11,405,432,837
140148312,14,14,83,12,483,531,1014
140148313,14,14,83,13,387,426,813
140148314,14,14,83,14,440,489,929
140148315,14,14,83,15,288,359,647
140148316,14,14,83,16,220,266,486
140148401,14,14,84,1,425,498,923
140148402,14,14,84,2,425,502,927
140148403,14,14,84,3,393,433,826
140148404,14,14,84,4,288,343,631
140148405,14,14,84,5,463,493,956
140148406,14,14,84,6,276,310,586
140148407,14,14,84,7,255,282,537
140148408,14,14,84,8,309,396,705
140148409,14,14,84,9,378,424,802
140148410,14,14,84,10,329,367,696
140148411,14,14,84,11,360,383,743
140148412,14,14,84,12,306,413,719
140148501,14,14,85,1,439,472,911
140148502,14,14,85,2,307,374,681
140148503,14,14,85,3,309,384,693
140148504,14,14,85,4,402,445,847
140148505,14,14,85,5,451,513,964
140148506,14,14,85,6,499,504,1003
140148507,14,14,85,7,316,396,712
140148508,14,14,85,8,682,758,1440
140148509,14,14,85,9,741,815,1556
140148510,14,14,85,10,609,673,1282
140148511,14,14,85,11,664,706,1370
140148512,14,14,85,12,556,599,1155
140148513,14,14,85,13,612,644,1256
140148514,14,14,85,14,590,627,1217
140148515,14,14,85,15,306,340,646
140148516,14,14,85,16,391,468,859
140148601,14,14,86,1,507,476,983
140148602,14,14,86,2,328,332,660
140148603,14,14,86,3,523,509,1032
140148604,14,14,86,4,675,682,1357
140148605,14,14,86,5,720,727,1447
140148606,14,14,86,6,598,678,1276
140148607,14,14,86,7,662,671,1333
140148608,14,14,86,8,521,559,1080
140148609,14,14,86,9,552,541,1093
140148610,14,14,86,10,720,765,1485
140148611,14,14,86,11,416,457,873
140148612,14,14,86,12,464,476,940
140148701,14,14,87,1,500,532,1032
140148702,14,14,87,2,433,429,862
140148703,14,14,87,3,336,385,721
140148704,14,14,87,4,407,408,815
140148705,14,14,87,5,733,712,1445
140148706,14,14,87,6,360,382,742
140148707,14,14,87,7,456,480,936
140148708,14,14,87,8,745,802,1547
140148709,14,14,87,9,385,387,772
140148710,14,14,87,10,464,489,953
140148711,14,14,87,11,616,598,1214
140148712,14,14,87,12,581,520,1101
140148713,14,14,87,13,293,315,608
140148801,14,14,88,1,347,397,744
140148802,14,14,88,2,489,492,981
140148803,14,14,88,3,444,486,930
140148804,14,14,88,4,379,415,794
140148805,14,14,88,5,193,206,399
140148806,14,14,88,6,425,491,916
140148807,14,14,88,7,445,510,955
140148808,14,14,88,8,371,414,785
140148809,14,14,88,9,416,427,843
140148810,14,14,88,10,411,479,890
140148811,14,14,88,11,599,660,1259
140148812,14,14,88,12,495,537,1032
140148813,14,14,88,13,537,572,1109
140148814,14,14,88,14,725,768,1493
140148815,14,14,88,15,552,588,1140
140148901,14,14,89,1,344,393,737
140148902,14,14,89,2,269,314,583
140148903,14,14,89,3,501,597,1098
140148904,14,14,89,4,526,591,1117
140148905,14,14,89,5,327,348,675
140148906,14,14,89,6,451,522,973
140148907,14,14,89,7,432,464,896
140148908,14,14,89,8,351,347,698
140148909,14,14,89,9,387,478,865
140148910,14,14,89,10,403,443,846
140148911,14,14,89,11,373,435,808
140148912,14,14,89,12,454,499,953
140148913,14,14,89,13,435,471,906
140148914,14,14,89,14,406,411,817
140148915,14,14,89,15,556,617,1173
140148916,14,14,89,16,791,866,1657
140149001,14,14,90,1,329,343,672
140149002,14,14,90,2,492,451,943
140149003,14,14,90,3,330,342,672
140149004,14,14,90,4,283,298,581
140149005,14,14,90,5,379,417,796
140149006,14,14,90,6,581,600,1181
140149007,14,14,90,7,601,624,1225
140149008,14,14,90,8,270,316,586
140149009,14,14,90,9,332,391,723
140149010,14,14,90,10,318,370,688
140149011,14,14,90,11,402,446,848
140149012,14,14,90,12,500,547,1047
140149013,14,14,90,13,695,724,1419
140149014,14,14,90,14,366,405,771
140149015,14,14,90,15,391,471,862
140149101,14,14,91,1,581,635,1216
140149102,14,14,91,2,458,491,949
140149103,14,14,91,3,366,417,783
140149104,14,14,91,4,538,596,1134
140149105,14,14,91,5,440,482,922
140149106,14,14,91,6,424,507,931
140149107,14,14,91,7,407,400,807
140149108,14,14,91,8,345,377,722
140149109,14,14,91,9,210,250,460
140149110,14,14,91,10,376,410,786
140149111,14,14,91,11,402,414,816
140149112,14,14,91,12,429,477,906
140149113,14,14,91,13,427,517,944
140149114,14,14,91,14,602,673,1275
140149115,14,14,91,15,466,456,922
140149116,14,14,91,16,360,394,754
140149117,14,14,91,17,419,453,872
140149118,14,14,91,18,469,514,983
140149119,14,14,91,19,439,494,933
140149120,14,14,91,20,294,293,587
140149201,14,14,92,1,360,428,788
140149202,14,14,92,2,225,255,480
140149203,14,14,92,3,225,277,502
140149204,14,14,92,4,458,462,920
140149205,14,14,92,5,398,443,841
140149206,14,14,92,6,364,421,785
140149207,14,14,92,7,284,343,627
140149208,14,14,92,8,316,336,652
140149209,14,14,92,9,364,440,804
140149210,14,14,92,10,305,338,643
140149211,14,14,92,11,373,407,780
140149212,14,14,92,12,426,441,867
140149213,14,14,92,13,216,260,476
140149214,14,14,92,14,421,480,901
140149215,14,14,92,15,323,343,666
140149216,14,14,92,16,396,457,853
140149217,14,14,92,17,410,495,905
140149218,14,14,92,18,193,243,436
140149301,14,14,93,1,342,406,748
140149302,14,14,93,2,361,408,769
140149303,14,14,93,3,527,621,1148
140149304,14,14,93,4,666,729,1395
140149305,14,14,93,5,422,476,898
140149306,14,14,93,6,581,652,1233
140149307,14,14,93,7,549,555,1104
140149308,14,14,93,8,620,718,1338
140149309,14,14,93,9,396,444,840
140149310,14,14,93,10,515,598,1113
140149311,14,14,93,11,694,737,1431
140149312,14,14,93,12,633,744,1377
140149313,14,14,93,13,347,389,736
140149314,14,14,93,14,231,264,495
140149315,14,14,93,15,429,444,873
140149316,14,14,93,16,358,416,774
140149317,14,14,93,17,756,842,1598
140149318,14,14,93,18,411,463,874
140149319,14,14,93,19,554,614,1168
140149320,14,14,93,20,297,326,623
140149321,14,14,93,21,430,483,913
140149401,14,14,94,1,501,594,1095
140149402,14,14,94,2,501,498,999
140149403,14,14,94,3,371,413,784
140149404,14,14,94,4,919,977,1896
140149405,14,14,94,5,629,698,1327
140149406,14,14,94,6,482,530,1012
140149407,14,14,94,7,818,829,1647
140149408,14,14,94,8,922,961,1883
140149409,14,14,94,9,615,610,1225
140149410,14,14,94,10,492,506,998
140149411,14,14,94,11,542,570,1112
140149412,14,14,94,12,555,643,1198
140149413,14,14,94,13,514,551,1065
140149414,14,14,94,14,416,438,854
140149501,14,14,95,1,347,393,740
140149502,14,14,95,2,345,360,705
140149503,14,14,95,3,335,344,679
140149504,14,14,95,4,655,676,1331
140149505,14,14,95,5,662,705,1367
140149506,14,14,95,6,568,658,1226
140149507,14,14,95,7,608,603,1211
140149508,14,14,95,8,736,715,1451
140149509,14,14,95,9,434,487,921
140149510,14,14,95,10,474,593,1067
140149511,14,14,95,11,503,474,977
140149512,14,14,95,12,825,854,1679
140149513,14,14,95,13,731,772,1503
140149514,14,14,95,14,719,726,1445
140149601,14,14,96,1,390,379,769
140149602,14,14,96,2,372,377,749
140149603,14,14,96,3,564,607,1171
140149604,14,14,96,4,532,641,1173
140149605,14,14,96,5,444,450,894
140149606,14,14,96,6,361,381,742
140149607,14,14,96,7,333,369,702
140149608,14,14,96,8,475,491,966
140149609,14,14,96,9,460,496,956
140149610,14,14,96,10,561,572,1133
140149611,14,14,96,11,417,456,873
140149612,14,14,96,12,531,592,1123
140149613,14,14,96,13,594,607,1201
140149614,14,14,96,14,377,405,782
140149615,14,14,96,15,370,367,737
140149616,14,14,96,16,686,673,1359
140149617,14,14,96,17,909,862,1771
140149701,14,14,97,1,1016,1019,2035
140149702,14,14,97,2,377,385,762
140149703,14,14,97,3,403,468,871
140149704,14,14,97,4,334,366,700
140149705,14,14,97,5,374,432,806
140149706,14,14,97,6,845,844,1689
140149707,14,14,97,7,682,637,1319
140149708,14,14,97,8,777,765,1542
140149709,14,14,97,9,759,828,1587
140149710,14,14,97,10,628,659,1287
140149711,14,14,97,11,744,761,1505
140149712,14,14,97,12,504,520,1024
140149713,14,14,97,13,414,410,824
140149714,14,14,97,14,868,871,1739
140149715,14,14,97,15,581,628,1209
140149716,14,14,97,16,571,586,1157
140149717,14,14,97,17,918,970,1888
140149801,14,14,98,1,431,516,947
140149802,14,14,98,2,627,634,1261
140149803,14,14,98,3,451,475,926
140149804,14,14,98,4,455,452,907
140149805,14,14,98,5,312,344,656
140149806,14,14,98,6,456,460,916
140149807,14,14,98,7,789,764,1553
140149808,14,14,98,8,426,468,894
140149809,14,14,98,9,550,575,1125
140149810,14,14,98,10,378,424,802
140149811,14,14,98,11,401,442,843
140149812,14,14,98,12,477,479,956
140149813,14,14,98,13,766,818,1584
140149901,14,14,99,1,568,613,1181
140149902,14,14,99,2,540,579,1119
140149903,14,14,99,3,604,679,1283
140149904,14,14,99,4,379,398,777
140149905,14,14,99,5,369,395,764
140149906,14,14,99,6,505,561,1066
140149907,14,14,99,7,397,411,808
140149908,14,14,99,8,756,795,1551
140149909,14,14,99,9,546,601,1147
140149910,14,14,99,10,608,619,1227
140149911,14,14,99,11,350,419,769
140149912,14,14,99,12,469,453,922
140149913,14,14,99,13,821,832,1653
140210101,14,21,1,1,37,24,61
140210102,14,21,1,2,47,38,85
140210103,14,21,1,3,81,77,158
140210104,14,21,1,4,204,190,394
140210105,14,21,1,5,139,125,264
140210106,14,21,1,6,289,262,551
140210107,14,21,1,7,260,272,532
140210108,14,21,1,8,214,239,453
140210109,14,21,1,9,280,264,544
140210110,14,21,1,10,181,195,376
140210201,14,21,2,1,29,21,50
140210202,14,21,2,2,39,37,76
140210203,14,21,2,3,24,22,46
140210204,14,21,2,4,88,62,150
140210205,14,21,2,5,179,182,361
140210206,14,21,2,6,119,134,253
140210207,14,21,2,7,218,227,445
140210208,14,21,2,8,138,151,289
140210209,14,21,2,9,287,271,558
140210210,14,21,2,10,204,188,392
140210211,14,21,2,11,125,109,234
140210212,14,21,2,12,173,188,361
140210213,14,21,2,13,253,278,531
140210301,14,21,3,1,85,99,184
140210302,14,21,3,2,198,198,396
140210303,14,21,3,3,357,329,686
140210304,14,21,3,4,419,419,838
140210305,14,21,3,5,202,209,411
140210306,14,21,3,6,207,189,396
140210307,14,21,3,7,86,58,144
140210308,14,21,3,8,189,167,356
140210309,14,21,3,9,293,346,639
140210310,14,21,3,10,188,160,348
140210311,14,21,3,11,229,198,427
140210312,14,21,3,12,214,205,419
140210313,14,21,3,13,183,180,363
140210314,14,21,3,14,544,565,1109
140210315,14,21,3,15,537,464,1001
140210316,14,21,3,16,465,462,927
140210401,14,21,4,1,146,143,289
140210402,14,21,4,2,139,122,261
140210403,14,21,4,3,234,248,482
140210404,14,21,4,4,165,175,340
140210405,14,21,4,5,181,152,333
140210406,14,21,4,6,444,470,914
140210407,14,21,4,7,493,518,1011
140210408,14,21,4,8,150,173,323
140210409,14,21,4,9,639,654,1293
140210410,14,21,4,10,496,486,982
140210501,14,21,5,1,90,81,171
140210502,14,21,5,2,134,155,289
140210503,14,21,5,3,28,16,44
140210504,14,21,5,4,117,100,217
140210505,14,21,5,5,105,98,203
140210506,14,21,5,6,230,262,492
140210507,14,21,5,7,399,425,824
140210508,14,21,5,8,434,428,862
140210601,14,21,6,1,109,83,192
140210602,14,21,6,2,55,43,98
140210603,14,21,6,3,40,40,80
140210604,14,21,6,4,74,78,152
140210605,14,21,6,5,170,174,344
140210606,14,21,6,6,32,32,64
140210607,14,21,6,7,103,106,209
140210608,14,21,6,8,483,468,951
140210609,14,21,6,9,449,478,927
140210610,14,21,6,10,290,306,596
140210611,14,21,6,11,794,827,1621
140210612,14,21,6,12,628,691,1319
140210613,14,21,6,13,436,478,914
140210614,14,21,6,14,713,800,1513
140210615,14,21,6,15,813,795,1608
140210616,14,21,6,16,572,584,1156
140210701,14,21,7,1,132,108,240
140210702,14,21,7,2,330,295,625
140210703,14,21,7,3,160,144,304
140210704,14,21,7,4,368,352,720
140210705,14,21,7,5,755,767,1522
140210706,14,21,7,6,614,646,1260
140210707,14,21,7,7,634,643,1277
140210708,14,21,7,8,576,618,1194
140210709,14,21,7,9,513,516,1029
140210710,14,21,7,10,399,408,807
140210711,14,21,7,11,474,495,969
140210712,14,21,7,12,400,404,804
140210713,14,21,7,13,104,93,197
140210714,14,21,7,14,395,357,752
140210715,14,21,7,15,570,582,1152
140210716,14,21,7,16,315,311,626
140210801,14,21,8,1,87,70,157
140210802,14,21,8,2,338,270,608
140210803,14,21,8,3,893,846,1739
140210804,14,21,8,4,611,595,1206
140210805,14,21,8,5,627,630,1257
140210806,14,21,8,6,267,261,528
140210807,14,21,8,7,726,745,1471
140210808,14,21,8,8,464,503,967
140210809,14,21,8,9,801,806,1607
140210810,14,21,8,10,462,495,957
140210811,14,21,8,11,459,418,877
140210812,14,21,8,12,509,473,982
140210813,14,21,8,13,528,558,1086
140210814,14,21,8,14,643,606,1249
140210901,14,21,9,1,405,406,811
140210902,14,21,9,2,435,418,853
140210903,14,21,9,3,355,387,742
140210904,14,21,9,4,303,334,637
140210905,14,21,9,5,225,298,523
140210906,14,21,9,6,455,464,919
140210907,14,21,9,7,246,311,557
140210908,14,21,9,8,213,244,457
140210909,14,21,9,9,264,345,609
140210910,14,21,9,10,476,525,1001
140210911,14,21,9,11,1221,716,1937
140210912,14,21,9,12,300,336,636
140210913,14,21,9,13,420,457,877
140210914,14,21,9,14,447,508,955
140211001,14,21,10,1,626,702,1328
140211002,14,21,10,2,378,430,808
140211003,14,21,10,3,420,488,908
140211004,14,21,10,4,575,645,1220
140211005,14,21,10,5,399,442,841
140211006,14,21,10,6,552,572,1124
140211007,14,21,10,7,281,313,594
140211008,14,21,10,8,429,508,937
140211009,14,21,10,9,336,384,720
140211010,14,21,10,10,403,493,896
140211011,14,21,10,11,707,697,1404
140211012,14,21,10,12,884,855,1739
140211013,14,21,10,13,767,783,1550
140211014,14,21,10,14,733,809,1542
140211015,14,21,10,15,250,254,504
140211016,14,21,10,16,434,502,936
140211101,14,21,11,1,409,425,834
140211102,14,21,11,2,529,511,1040
140211103,14,21,11,3,340,341,681
140211104,14,21,11,4,434,407,841
140211105,14,21,11,5,356,393,749
140211106,14,21,11,6,174,183,357
140211107,14,21,11,7,409,459,868
140211108,14,21,11,8,409,475,884
140211109,14,21,11,9,667,678,1345
140211110,14,21,11,10,323,301,624
140211111,14,21,11,11,357,364,721
140211112,14,21,11,12,593,650,1243
140211113,14,21,11,13,444,510,954
140211114,14,21,11,14,383,419,802
140211115,14,21,11,15,311,370,681
140211116,14,21,11,16,318,361,679
140211117,14,21,11,17,365,429,794
140211118,14,21,11,18,527,590,1117
140211119,14,21,11,19,452,502,954
140211201,14,21,12,1,314,300,614
140211202,14,21,12,2,287,304,591
140211203,14,21,12,3,449,475,924
140211204,14,21,12,4,334,359,693
140211205,14,21,12,5,404,426,830
140211206,14,21,12,6,364,361,725
140211207,14,21,12,7,305,352,657
140211208,14,21,12,8,211,204,415
140211209,14,21,12,9,188,214,402
140211210,14,21,12,10,354,392,746
140211211,14,21,12,11,390,417,807
140211212,14,21,12,12,370,356,726
140211213,14,21,12,13,323,332,655
140211214,14,21,12,14,384,443,827
140211301,14,21,13,1,403,408,811
140211302,14,21,13,2,247,262,509
140211303,14,21,13,3,364,388,752
140211304,14,21,13,4,301,330,631
140211305,14,21,13,5,471,490,961
140211306,14,21,13,6,340,319,659
140211307,14,21,13,7,283,314,597
140211308,14,21,13,8,549,609,1158
140211309,14,21,13,9,319,325,644
140211310,14,21,13,10,327,387,714
140211311,14,21,13,11,256,324,580
140211312,14,21,13,12,274,340,614
140211313,14,21,13,13,341,377,718
140211314,14,21,13,14,398,426,824
140211401,14,21,14,1,308,376,684
140211402,14,21,14,2,221,250,471
140211403,14,21,14,3,255,268,523
140211404,14,21,14,4,416,472,888
140211405,14,21,14,5,451,472,923
140211406,14,21,14,6,477,442,919
140211407,14,21,14,7,568,590,1158
140211408,14,21,14,8,320,365,685
140211409,14,21,14,9,327,327,654
140211410,14,21,14,10,371,412,783
140211411,14,21,14,11,488,528,1016
140211412,14,21,14,12,380,432,812
140211501,14,21,15,1,304,334,638
140211502,14,21,15,2,367,425,792
140211503,14,21,15,3,361,385,746
140211504,14,21,15,4,363,402,765
140211505,14,21,15,5,310,332,642
140211506,14,21,15,6,381,468,849
140211507,14,21,15,7,381,399,780
140211508,14,21,15,8,180,190,370
140211509,14,21,15,9,296,277,573
140211510,14,21,15,10,303,368,671
140211511,14,21,15,11,286,315,601
140211601,14,21,16,1,510,491,1001
140211602,14,21,16,2,579,638,1217
140211603,14,21,16,3,339,407,746
140211604,14,21,16,4,505,499,1004
140211605,14,21,16,5,491,495,986
140211606,14,21,16,6,611,635,1246
140211607,14,21,16,7,418,420,838
140211608,14,21,16,8,354,393,747
140211609,14,21,16,9,382,361,743
140211610,14,21,16,10,398,390,788
140211611,14,21,16,11,656,687,1343
140211701,14,21,17,1,401,403,804
140211702,14,21,17,2,368,387,755
140211703,14,21,17,3,348,379,727
140211704,14,21,17,4,407,395,802
140211705,14,21,17,5,326,321,647
140211706,14,21,17,6,529,558,1087
140211707,14,21,17,7,555,589,1144
140211708,14,21,17,8,766,785,1551
140211709,14,21,17,9,778,871,1649
140211710,14,21,17,10,549,556,1105
140211801,14,21,18,1,368,359,727
140211802,14,21,18,2,447,439,886
140211803,14,21,18,3,321,357,678
140211804,14,21,18,4,362,442,804
140211805,14,21,18,5,457,523,980
140211806,14,21,18,6,455,422,877
140211807,14,21,18,7,484,504,988
140211808,14,21,18,8,548,591,1139
140211809,14,21,18,9,537,561,1098
140211810,14,21,18,10,484,575,1059
140211811,14,21,18,11,376,456,832
140211812,14,21,18,12,587,687,1274
140211813,14,21,18,13,713,757,1470
140211814,14,21,18,14,295,371,666
140211815,14,21,18,15,497,572,1069
140211816,14,21,18,16,530,577,1107
140211901,14,21,19,1,424,424,848
140211902,14,21,19,2,431,465,896
140211903,14,21,19,3,306,304,610
140211904,14,21,19,4,301,303,604
140211905,14,21,19,5,383,420,803
140211906,14,21,19,6,281,333,614
140211907,14,21,19,7,266,291,557
140211908,14,21,19,8,279,291,570
140211909,14,21,19,9,468,521,989
140211910,14,21,19,10,524,566,1090
140211911,14,21,19,11,437,515,952
140211912,14,21,19,12,368,383,751
140211913,14,21,19,13,398,402,800
140212001,14,21,20,1,364,366,730
140212002,14,21,20,2,351,352,703
140212003,14,21,20,3,580,623,1203
140212004,14,21,20,4,497,490,987
140212005,14,21,20,5,609,605,1214
140212006,14,21,20,6,437,481,918
140212007,14,21,20,7,596,670,1266
140212008,14,21,20,8,424,435,859
140212009,14,21,20,9,389,410,799
140212010,14,21,20,10,416,458,874
140212011,14,21,20,11,286,311,597
140212012,14,21,20,12,331,381,712
140212013,14,21,20,13,382,425,807
140212014,14,21,20,14,663,682,1345
140212015,14,21,20,15,425,505,930
140212016,14,21,20,16,325,335,660
140212017,14,21,20,17,338,347,685
140212018,14,21,20,18,577,540,1117
140212101,14,21,21,1,471,478,949
140212102,14,21,21,2,356,346,702
140212103,14,21,21,3,383,346,729
140212104,14,21,21,4,84,99,183
140212105,14,21,21,5,472,490,962
140212106,14,21,21,6,500,540,1040
140212107,14,21,21,7,344,377,721
140212108,14,21,21,8,337,364,701
140212109,14,21,21,9,344,365,709
140212110,14,21,21,10,653,638,1291
140212111,14,21,21,11,151,169,320
140212112,14,21,21,12,303,303,606
140212113,14,21,21,13,531,551,1082
140212114,14,21,21,14,383,384,767
140212115,14,21,21,15,321,340,661
140212116,14,21,21,16,490,563,1053
140212117,14,21,21,17,268,273,541
140212118,14,21,21,18,690,746,1436
140212119,14,21,21,19,278,259,537
140212120,14,21,21,20,284,292,576
140280101,14,28,1,1,52,32,84
140280102,14,28,1,2,294,263,557
140280103,14,28,1,3,160,135,295
140280104,14,28,1,4,493,401,894
140280105,14,28,1,5,308,342,650
140280106,14,28,1,6,150,152,302
140280107,14,28,1,7,53,44,97
140280108,14,28,1,8,191,180,371
140280109,14,28,1,9,410,390,800
140280110,14,28,1,10,909,840,1749
140280111,14,28,1,11,469,468,937
140280201,14,28,2,1,874,875,1749
140280202,14,28,2,2,469,484,953
140280203,14,28,2,3,510,550,1060
140280204,14,28,2,4,815,888,1703
140280205,14,28,2,5,387,425,812
140280206,14,28,2,6,259,332,591
140280207,14,28,2,7,280,362,642
140280208,14,28,2,8,590,679,1269
140280209,14,28,2,9,434,540,974
140280210,14,28,2,10,382,457,839
140280211,14,28,2,11,578,629,1207
140280212,14,28,2,12,516,607,1123
140280213,14,28,2,13,561,593,1154
140280214,14,28,2,14,492,634,1126
140280215,14,28,2,15,636,736,1372
140280216,14,28,2,16,634,740,1374
140280301,14,28,3,1,585,631,1216
140280302,14,28,3,2,595,638,1233
140280303,14,28,3,3,530,592,1122
140280304,14,28,3,4,550,654,1204
140280305,14,28,3,5,554,598,1152
140280306,14,28,3,6,283,370,653
140280307,14,28,3,7,346,391,737
140280308,14,28,3,8,254,326,580
140280309,14,28,3,9,383,467,850
140280310,14,28,3,10,492,551,1043
140280311,14,28,3,11,1644,631,2275
140280312,14,28,3,12,326,341,667
140280401,14,28,4,1,50,31,81
140280402,14,28,4,2,194,150,344
140280403,14,28,4,3,279,268,547
140280404,14,28,4,4,212,202,414
140280405,14,28,4,5,174,152,326
140280406,14,28,4,6,357,398,755
140280407,14,28,4,7,453,430,883
140280408,14,28,4,8,405,398,803
140280409,14,28,4,9,516,517,1033
140280410,14,28,4,10,464,443,907
140280501,14,28,5,1,413,326,739
140280502,14,28,5,2,280,242,522
140280503,14,28,5,3,77,65,142
140280504,14,28,5,4,229,149,378
140280505,14,28,5,5,504,497,1001
140280506,14,28,5,6,563,615,1178
140280507,14,28,5,7,563,560,1123
140280508,14,28,5,8,500,514,1014
140280509,14,28,5,9,276,365,641
140280510,14,28,5,10,365,393,758
140280511,14,28,5,11,424,558,982
140280512,14,28,5,12,427,411,838
140280513,14,28,5,13,361,383,744
140280514,14,28,5,14,661,688,1349
140280515,14,28,5,15,196,208,404
140280601,14,28,6,1,42,32,74
140280602,14,28,6,2,132,140,272
140280603,14,28,6,3,210,220,430
140280604,14,28,6,4,113,105,218
140280605,14,28,6,5,30,37,67
140280606,14,28,6,6,266,294,560
140280607,14,28,6,7,456,487,943
140280701,14,28,7,1,100,94,194
140280702,14,28,7,2,107,91,198
140280703,14,28,7,3,81,50,131
140280704,14,28,7,4,25,16,41
140280705,14,28,7,5,35,24,59
140280706,14,28,7,6,142,108,250
140350101,14,35,1,1,32,9,41
140350102,14,35,1,2,27,11,38
140350103,14,35,1,3,94,57,151
140350104,14,35,1,4,53,16,69
140350105,14,35,1,5,53,26,79
140350106,14,35,1,6,78,54,132
140350107,14,35,1,7,190,183,373
140350108,14,35,1,8,574,612,1186
140350109,14,35,1,9,459,485,944
140350110,14,35,1,10,441,407,848
140350201,14,35,2,1,50,34,84
140350202,14,35,2,2,49,34,83
140350203,14,35,2,3,30,24,54
140350204,14,35,2,4,34,22,56
140350205,14,35,2,5,26,19,45
140350206,14,35,2,6,164,164,328
140350207,14,35,2,7,37,30,67
140350208,14,35,2,8,87,47,134
140350209,14,35,2,9,31,17,48
140350210,14,35,2,10,334,323,657
140350211,14,35,2,11,380,374,754
140350212,14,35,2,12,441,522,963
140350213,14,35,2,13,529,509,1038
140350214,14,35,2,14,389,412,801
140350215,14,35,2,15,503,493,996
140350301,14,35,3,1,75,48,123
140350302,14,35,3,2,33,19,52
140350303,14,35,3,3,230,120,350
140350304,14,35,3,4,126,94,220
140350305,14,35,3,5,137,93,230
140350306,14,35,3,6,113,90,203
140350307,14,35,3,7,309,213,522
140350308,14,35,3,8,78,55,133
140350309,14,35,3,9,80,39,119
140350310,14,35,3,10,253,251,504
140350311,14,35,3,11,477,476,953
140350312,14,35,3,12,389,387,776
140350313,14,35,3,13,398,414,812
140350314,14,35,3,14,361,378,739
140350315,14,35,3,15,453,503,956
140350316,14,35,3,16,343,368,711
140350317,14,35,3,17,535,532,1067
140350318,14,35,3,18,549,541,1090
140350401,14,35,4,1,51,29,80
140350402,14,35,4,2,99,66,165
140350403,14,35,4,3,119,87,206
140350404,14,35,4,4,368,360,728
140350405,14,35,4,5,449,461,910
140350406,14,35,4,6,554,605,1159
140350407,14,35,4,7,387,398,785
140350408,14,35,4,8,225,279,504
140350409,14,35,4,9,339,376,715
140350410,14,35,4,10,252,304,556
140350411,14,35,4,11,226,241,467
140350412,14,35,4,12,385,410,795
140350413,14,35,4,13,368,364,732
140350414,14,35,4,14,488,518,1006
140350415,14,35,4,15,551,518,1069
140350501,14,35,5,1,21,3,24
140350502,14,35,5,2,85,18,103
140350503,14,35,5,3,48,24,72
140350504,14,35,5,4,74,47,121
140350505,14,35,5,5,64,44,108
140350506,14,35,5,6,71,38,109
140350507,14,35,5,7,33,13,46
140350508,14,35,5,8,366,384,750
140350509,14,35,5,9,345,346,691
140350510,14,35,5,10,357,366,723
140350511,14,35,5,11,336,388,724
140350512,14,35,5,12,613,597,1210
140350513,14,35,5,13,396,417,813
140350514,14,35,5,14,347,398,745
140420101,14,42,1,1,79,58,137
140420102,14,42,1,2,56,53,109
140420103,14,42,1,3,112,89,201
140420104,14,42,1,4,71,57,128
140420105,14,42,1,5,180,153,333
140420106,14,42,1,6,91,63,154
140420107,14,42,1,7,136,102,238
140420108,14,42,1,8,177,131,308
140420109,14,42,1,9,560,571,1131
140420110,14,42,1,10,279,371,650
140420111,14,42,1,11,458,433,891
140420112,14,42,1,12,187,199,386
140420201,14,42,2,1,77,54,131
140420202,14,42,2,2,115,103,218
140420203,14,42,2,3,98,69,167
140420204,14,42,2,4,73,48,121
140420205,14,42,2,5,170,139,309
140420206,14,42,2,6,64,45,109
140420207,14,42,2,7,81,56,137
140420208,14,42,2,8,266,205,471
140420209,14,42,2,9,247,217,464
140420210,14,42,2,10,327,350,677
140420301,14,42,3,1,175,135,310
140420302,14,42,3,2,168,153,321
140420303,14,42,3,3,108,98,206
140420304,14,42,3,4,87,85,172
140420305,14,42,3,5,101,85,186
140420306,14,42,3,6,17,11,28
140420307,14,42,3,7,317,267,584
140420308,14,42,3,8,313,319,632
140420309,14,42,3,9,415,426,841
140420310,14,42,3,10,556,501,1057
140420311,14,42,3,11,350,407,757
140420312,14,42,3,12,157,197,354
140420313,14,42,3,13,537,602,1139
140420314,14,42,3,14,571,590,1161
140420401,14,42,4,1,564,583,1147
140420402,14,42,4,2,357,344,701
140420403,14,42,4,3,366,368,734
140420404,14,42,4,4,560,586,1146
140420405,14,42,4,5,488,575,1063
140420406,14,42,4,6,549,545,1094
140420407,14,42,4,7,565,587,1152
140420408,14,42,4,8,540,535,1075
140420409,14,42,4,9,468,467,935
140420410,14,42,4,10,433,478,911
140420411,14,42,4,11,479,542,1021
140420412,14,42,4,12,460,491,951
140420413,14,42,4,13,597,599,1196
140420414,14,42,4,14,421,426,847
140420415,14,42,4,15,734,739,1473
140420416,14,42,4,16,322,347,669
140420417,14,42,4,17,424,426,850
140420418,14,42,4,18,585,572,1157
140420419,14,42,4,19,349,347,696
140420501,14,42,5,1,55,36,91
140420502,14,42,5,2,45,44,89
140420503,14,42,5,3,34,26,60
140420504,14,42,5,4,79,59,138
140420505,14,42,5,5,53,57,110
140420506,14,42,5,6,65,47,112
140420507,14,42,5,7,85,58,143
140420508,14,42,5,8,155,112,267
140420509,14,42,5,9,118,98,216
140420510,14,42,5,10,290,273,563
140420511,14,42,5,11,256,246,502
140420512,14,42,5,12,384,371,755
140420513,14,42,5,13,340,332,672
140420514,14,42,5,14,389,372,761
140420515,14,42,5,15,302,303,605
140420516,14,42,5,16,286,287,573
140420517,14,42,5,17,537,509,1046
140420601,14,42,6,1,474,458,932
140420602,14,42,6,2,377,359,736
140420603,14,42,6,3,983,584,1567
140420604,14,42,6,4,385,443,828
140420605,14,42,6,5,345,381,726
140420606,14,42,6,6,424,424,848
140420607,14,42,6,7,251,292,543
140420608,14,42,6,8,530,596,1126
140420609,14,42,6,9,392,436,828
140420610,14,42,6,10,230,260,490
140420611,14,42,6,11,328,407,735
140420612,14,42,6,12,191,236,427
140420613,14,42,6,13,302,416,718
140420614,14,42,6,14,309,395,704
140420615,14,42,6,15,608,612,1220
140420616,14,42,6,16,592,630,1222
140420617,14,42,6,17,340,414,754
140420618,14,42,6,18,288,297,585
140420619,14,42,6,19,170,270,440
140420620,14,42,6,20,187,226,413
140420621,14,42,6,21,685,693,1378
140420701,14,42,7,1,663,620,1283
140420702,14,42,7,2,469,511,980
140420703,14,42,7,3,650,640,1290
140420704,14,42,7,4,315,390,705
140420705,14,42,7,5,410,511,921
140420706,14,42,7,6,289,375,664
140420707,14,42,7,7,347,463,810
140420708,14,42,7,8,443,485,928
140420709,14,42,7,9,488,549,1037
140420710,14,42,7,10,637,653,1290
140420711,14,42,7,11,1053,1030,2083
140420712,14,42,7,12,403,403,806
140420713,14,42,7,13,347,393,740
140420714,14,42,7,14,203,235,438
140420715,14,42,7,15,673,688,1361
140420801,14,42,8,1,260,320,580
140420802,14,42,8,2,146,212,358
140420803,14,42,8,3,369,436,805
140420804,14,42,8,4,176,206,382
140420805,14,42,8,5,336,386,722
140420806,14,42,8,6,283,363,646
140420807,14,42,8,7,311,388,699
140420808,14,42,8,8,248,295,543
140420809,14,42,8,9,368,388,756
140420810,14,42,8,10,420,496,916
140420811,14,42,8,11,245,302,547
140420812,14,42,8,12,416,448,864
140420813,14,42,8,13,213,248,461
140420814,14,42,8,14,313,326,639
140420815,14,42,8,15,499,508,1007
140420816,14,42,8,16,529,507,1036
140420817,14,42,8,17,230,259,489
140420818,14,42,8,18,413,436,849
140420819,14,42,8,19,719,742,1461
140420820,14,42,8,20,202,281,483
140420821,14,42,8,21,211,221,432
140420822,14,42,8,22,384,378,762
140420823,14,42,8,23,352,358,710
140420901,14,42,9,1,450,472,922
140420902,14,42,9,2,418,441,859
140420903,14,42,9,3,340,331,671
140420904,14,42,9,4,435,443,878
140420905,14,42,9,5,530,525,1055
140420906,14,42,9,6,513,549,1062
140420907,14,42,9,7,331,326,657
140420908,14,42,9,8,254,272,526
140420909,14,42,9,9,435,536,971
140420910,14,42,9,10,280,299,579
140420911,14,42,9,11,212,267,479
140420912,14,42,9,12,167,249,416
140420913,14,42,9,13,300,369,669
140420914,14,42,9,14,330,397,727
140420915,14,42,9,15,299,351,650
140420916,14,42,9,16,443,478,921
140420917,14,42,9,17,370,409,779
140420918,14,42,9,18,311,337,648
140420919,14,42,9,19,457,480,937
140420920,14,42,9,20,394,448,842
140420921,14,42,9,21,456,469,925
140420922,14,42,9,22,215,249,464
140420923,14,42,9,23,198,258,456
140420924,14,42,9,24,240,286,526
140420925,14,42,9,25,242,287,529
140421001,14,42,10,1,106,78,184
140421002,14,42,10,2,82,76,158
140421003,14,42,10,3,4,2,6
140421004,14,42,10,4,55,45,100
140421005,14,42,10,5,64,59,123
140421006,14,42,10,6,59,36,95
140421007,14,42,10,7,50,35,85
140421008,14,42,10,8,284,331,615
140421009,14,42,10,9,427,440,867
140421010,14,42,10,10,425,368,793
140421011,14,42,10,11,274,240,514
140421012,14,42,10,12,361,378,739
140421013,14,42,10,13,295,341,636
140421014,14,42,10,14,333,310,643
140421015,14,42,10,15,363,382,745
140421016,14,42,10,16,536,525,1061
140421101,14,42,11,1,369,417,786
140421102,14,42,11,2,328,328,656
140421103,14,42,11,3,430,454,884
140421104,14,42,11,4,379,432,811
140421105,14,42,11,5,536,506,1042
140421106,14,42,11,6,373,397,770
140421107,14,42,11,7,858,839,1697
140421108,14,42,11,8,676,689,1365
140421109,14,42,11,9,644,613,1257
140421110,14,42,11,10,400,431,831
140421111,14,42,11,11,450,473,923
140421112,14,42,11,12,409,474,883
140421113,14,42,11,13,293,302,595
140490101,14,49,1,1,56,49,105
140490102,14,49,1,2,62,62,124
140490103,14,49,1,3,124,101,225
140490104,14,49,1,4,72,59,131
140490105,14,49,1,5,89,61,150
140490106,14,49,1,6,51,35,86
140490107,14,49,1,7,46,30,76
140490108,14,49,1,8,109,101,210
140490109,14,49,1,9,174,164,338
140490110,14,49,1,10,37,28,65
140490111,14,49,1,11,278,279,557
140490112,14,49,1,12,222,224,446
140490113,14,49,1,13,526,625,1151
140490114,14,49,1,14,370,397,767
140490115,14,49,1,15,400,434,834
140490116,14,49,1,16,659,681,1340
140490201,14,49,2,1,463,371,834
140490202,14,49,2,2,80,62,142
140490203,14,49,2,3,45,35,80
140490204,14,49,2,4,177,103,280
140490205,14,49,2,5,47,33,80
140490206,14,49,2,6,41,29,70
140490207,14,49,2,7,106,95,201
140490208,14,49,2,8,14,8,22
140490209,14,49,2,9,32,25,57
140490210,14,49,2,10,72,48,120
140490211,14,49,2,11,238,229,467
140490212,14,49,2,12,56,50,106
140490213,14,49,2,13,112,93,205
140490214,14,49,2,14,279,271,550
140490215,14,49,2,15,130,152,282
140490301,14,49,3,1,355,343,698
140490302,14,49,3,2,343,348,691
140490303,14,49,3,3,511,635,1146
140490304,14,49,3,4,360,378,738
140490305,14,49,3,5,470,499,969
140490306,14,49,3,6,317,327,644
140490307,14,49,3,7,460,512,972
140490308,14,49,3,8,423,454,877
140490309,14,49,3,9,427,499,926
140490310,14,49,3,10,340,386,726
140490311,14,49,3,11,552,677,1229
140490312,14,49,3,12,454,516,970
140490313,14,49,3,13,366,446,812
140490314,14,49,3,14,374,429,803
140490315,14,49,3,15,152,182,334
140490316,14,49,3,16,308,372,680
140490317,14,49,3,17,279,330,609
140490318,14,49,3,18,296,372,668
140490319,14,49,3,19,499,619,1118
140490320,14,49,3,20,470,538,1008
140490321,14,49,3,21,388,392,780
140490322,14,49,3,22,554,649,1203
140490323,14,49,3,23,406,425,831
140490324,14,49,3,24,383,386,769
140490325,14,49,3,25,505,505,1010
140560101,14,56,1,1,114,75,189
140560102,14,56,1,2,113,88,201
140560103,14,56,1,3,88,89,177
140560104,14,56,1,4,609,670,1279
140560105,14,56,1,5,669,698,1367
140560106,14,56,1,6,581,593,1174
140560107,14,56,1,7,387,401,788
140560108,14,56,1,8,570,570,1140
140560109,14,56,1,9,504,500,1004
140560110,14,56,1,10,467,460,927
140560111,14,56,1,11,396,398,794
140560112,14,56,1,12,301,323,624
140560113,14,56,1,13,402,436,838
140560114,14,56,1,14,303,349,652
140560115,14,56,1,15,265,262,527
140560116,14,56,1,16,270,350,620
140560117,14,56,1,17,556,573,1129
140560118,14,56,1,18,358,380,738
140560201,14,56,2,1,72,43,115
140560202,14,56,2,2,27,27,54
140560203,14,56,2,3,13,9,22
140560204,14,56,2,4,298,296,594
140560205,14,56,2,5,558,577,1135
140560206,14,56,2,6,472,419,891
140560207,14,56,2,7,180,212,392
140560208,14,56,2,8,295,314,609
140560209,14,56,2,9,409,379,788
140560210,14,56,2,10,498,513,1011
140560211,14,56,2,11,531,511,1042
140560212,14,56,2,12,579,545,1124
140560213,14,56,2,13,912,864,1776
140560214,14,56,2,14,881,818,1699
140560301,14,56,3,1,9,7,16
140560302,14,56,3,2,58,38,96
140560303,14,56,3,3,155,96,251
140560304,14,56,3,4,121,81,202
140560305,14,56,3,5,63,57,120
140560306,14,56,3,6,22,20,42
140560307,14,56,3,7,17,12,29
140560308,14,56,3,8,47,39,86
140560309,14,56,3,9,64,51,115
140560310,14,56,3,10,100,101,201
140560311,14,56,3,11,444,471,915
140560312,14,56,3,12,366,407,773
140560313,14,56,3,13,459,523,982
140560314,14,56,3,14,366,342,708
140560315,14,56,3,15,241,292,533
140560316,14,56,3,16,457,456,913
140560317,14,56,3,17,293,311,604
140560318,14,56,3,18,319,304,623
140560319,14,56,3,19,544,544,1088
140560320,14,56,3,20,313,306,619
140560401,14,56,4,1,54,43,97
140560402,14,56,4,2,73,52,125
140560403,14,56,4,3,17,12,29
140560404,14,56,4,4,23,13,36
140560405,14,56,4,5,67,49,116
140560406,14,56,4,6,49,34,83
140560407,14,56,4,7,641,601,1242
140560408,14,56,4,8,250,240,490
140560409,14,56,4,9,353,359,712
140560410,14,56,4,10,364,352,716
140560411,14,56,4,11,311,330,641
140560412,14,56,4,12,280,312,592
140560413,14,56,4,13,473,489,962
140560414,14,56,4,14,420,422,842
140560415,14,56,4,15,389,444,833
140560501,14,56,5,1,36,28,64
140560502,14,56,5,2,37,23,60
140560503,14,56,5,3,25,20,45
140560504,14,56,5,4,83,51,134
140560505,14,56,5,5,18,11,29
140560506,14,56,5,6,109,111,220
140560507,14,56,5,7,89,57,146
140560508,14,56,5,8,294,281,575
140560509,14,56,5,9,270,286,556
140560601,14,56,6,1,110,81,191
140560602,14,56,6,2,61,51,112
140560603,14,56,6,3,51,36,87
140560604,14,56,6,4,34,28,62
140560605,14,56,6,5,47,40,87
140560606,14,56,6,6,46,24,70
140560607,14,56,6,7,53,42,95
140560608,14,56,6,8,88,68,156
140560609,14,56,6,9,140,117,257
140560610,14,56,6,10,77,56,133
140560611,14,56,6,11,91,71,162
140560612,14,56,6,12,128,77,205
140560613,14,56,6,13,132,92,224
140560614,14,56,6,14,31,28,59
140560615,14,56,6,15,406,430,836
140560616,14,56,6,16,361,345,706
140560617,14,56,6,17,424,435,859
140560618,14,56,6,18,275,284,559
140560701,14,56,7,1,344,343,687
140560702,14,56,7,2,313,333,646
140560703,14,56,7,3,460,517,977
140560704,14,56,7,4,360,402,762
140560705,14,56,7,5,275,311,586
140560706,14,56,7,6,493,536,1029
140560707,14,56,7,7,283,347,630
140560708,14,56,7,8,470,526,996
140560709,14,56,7,9,568,609,1177
140560710,14,56,7,10,376,381,757
140560711,14,56,7,11,535,568,1103
140560712,14,56,7,12,757,755,1512
140560713,14,56,7,13,561,547,1108
140560714,14,56,7,14,279,288,567
140630101,14,63,1,1,49,53,102
140630102,14,63,1,2,44,36,80
140630103,14,63,1,3,31,20,51
140630104,14,63,1,4,24,17,41
140630105,14,63,1,5,28,19,47
140630106,14,63,1,6,60,46,106
140630107,14,63,1,7,29,28,57
140630108,14,63,1,8,35,29,64
140630109,14,63,1,9,380,409,789
140630201,14,63,2,1,60,34,94
140630202,14,63,2,2,124,116,240
140630203,14,63,2,3,60,44,104
140630204,14,63,2,4,58,45,103
140630205,14,63,2,5,29,22,51
140630206,14,63,2,6,48,49,97
140630207,14,63,2,7,53,55,108
140630208,14,63,2,8,50,49,99
140630209,14,63,2,9,41,35,76
140630210,14,63,2,10,66,46,112
140630211,14,63,2,11,50,38,88
140630212,14,63,2,12,472,500,972
140630213,14,63,2,13,371,403,774
140630214,14,63,2,14,273,310,583
140630215,14,63,2,15,226,222,448
140630301,14,63,3,1,24,19,43
140630302,14,63,3,2,64,50,114
140630303,14,63,3,3,156,153,309
140630304,14,63,3,4,430,429,859
140630305,14,63,3,5,461,412,873
140630306,14,63,3,6,427,448,875
140630307,14,63,3,7,314,345,659
140630308,14,63,3,8,418,397,815
140630309,14,63,3,9,280,300,580
140630310,14,63,3,10,276,304,580
140630311,14,63,3,11,478,498,976
140630401,14,63,4,1,17,19,36
140630402,14,63,4,2,33,30,63
140630403,14,63,4,3,18,16,34
140630404,14,63,4,4,37,31,68
140630405,14,63,4,5,75,45,120
140630406,14,63,4,6,20,17,37
140630407,14,63,4,7,474,483,957
140630408,14,63,4,8,334,408,742
140630409,14,63,4,9,231,282,513
140630410,14,63,4,10,231,273,504
140630411,14,63,4,11,252,273,525
140630412,14,63,4,12,225,243,468
140630413,14,63,4,13,448,468,916
140630414,14,63,4,14,346,396,742
140630415,14,63,4,15,360,369,729
140630501,14,63,5,1,112,67,179
140630502,14,63,5,2,74,56,130
140630503,14,63,5,3,33,20,53
140630504,14,63,5,4,262,265,527
140630505,14,63,5,5,368,393,761
140630506,14,63,5,6,418,450,868
140630507,14,63,5,7,278,318,596
140630508,14,63,5,8,399,401,800
140630509,14,63,5,9,229,306,535
140630510,14,63,5,10,616,568,1184
140630511,14,63,5,11,337,341,678
140630512,14,63,5,12,255,245,500
140630513,14,63,5,13,303,397,700
140630514,14,63,5,14,333,351,684
140630515,14,63,5,15,429,465,894
140630516,14,63,5,16,379,427,806
140630517,14,63,5,17,216,203,419
140630601,14,63,6,1,9,7,16
140630602,14,63,6,2,6,7,13
140630603,14,63,6,3,72,57,129
140630604,14,63,6,4,59,52,111
140630605,14,63,6,5,39,37,76
140630606,14,63,6,6,48,42,90
140630607,14,63,6,7,371,417,788
140630608,14,63,6,8,273,305,578
140630609,14,63,6,9,453,436,889
140630610,14,63,6,10,308,328,636
140630611,14,63,6,11,403,462,865
140630612,14,63,6,12,269,316,585
140630613,14,63,6,13,417,439,856
140630614,14,63,6,14,249,234,483
140630615,14,63,6,15,383,355,738
140630701,14,63,7,1,146,136,282
140630702,14,63,7,2,74,67,141
140630703,14,63,7,3,52,50,102
140630704,14,63,7,4,54,30,84
140630705,14,63,7,5,71,51,122
140630706,14,63,7,6,389,434,823
140630707,14,63,7,7,342,370,712
140630708,14,63,7,8,370,397,767
140630709,14,63,7,9,370,443,813
140630710,14,63,7,10,225,217,442
140630711,14,63,7,11,423,381,804
140630801,14,63,8,1,42,38,80
140630802,14,63,8,2,54,34,88
140630803,14,63,8,3,70,46,116
140630804,14,63,8,4,99,84,183
140630805,14,63,8,5,31,24,55
140630806,14,63,8,6,37,17,54
140630807,14,63,8,7,231,272,503
140630808,14,63,8,8,311,361,672
140630809,14,63,8,9,282,317,599
140630810,14,63,8,10,308,346,654
140630811,14,63,8,11,354,280,634
140630812,14,63,8,12,287,281,568
140630901,14,63,9,1,35,28,63
140630902,14,63,9,2,62,54,116
140630903,14,63,9,3,108,93,201
140630904,14,63,9,4,95,82,177
140630905,14,63,9,5,73,65,138
140630906,14,63,9,6,29,37,66
140630907,14,63,9,7,61,40,101
140630908,14,63,9,8,69,58,127
140630909,14,63,9,9,86,66,152
140630910,14,63,9,10,251,267,518
140630911,14,63,9,11,260,300,560
140630912,14,63,9,12,272,348,620
140630913,14,63,9,13,277,314,591
140630914,14,63,9,14,517,493,1010
140630915,14,63,9,15,492,494,986
140630916,14,63,9,16,402,454,856
140630917,14,63,9,17,213,232,445
140630918,14,63,9,18,333,389,722
140630919,14,63,9,19,239,301,540
140630920,14,63,9,20,406,480,886
140630921,14,63,9,21,455,472,927
140630922,14,63,9,22,568,537,1105
140630923,14,63,9,23,287,321,608
140631001,14,63,10,1,335,296,631
140631002,14,63,10,2,472,467,939
140631003,14,63,10,3,500,521,1021
140631004,14,63,10,4,324,359,683
140631005,14,63,10,5,278,262,540
140631006,14,63,10,6,323,375,698
140631007,14,63,10,7,568,545,1113
140631008,14,63,10,8,262,321,583
140631009,14,63,10,9,329,350,679
140631010,14,63,10,10,307,319,626
140631011,14,63,10,11,276,319,595
140631012,14,63,10,12,471,520,991
140631013,14,63,10,13,637,655,1292
140631101,14,63,11,1,697,672,1369
140631102,14,63,11,2,532,527,1059
140631103,14,63,11,3,343,341,684
140631104,14,63,11,4,441,426,867
140631105,14,63,11,5,474,522,996
140631106,14,63,11,6,243,262,505
140631107,14,63,11,7,373,347,720
140631108,14,63,11,8,395,366,761
140631109,14,63,11,9,363,349,712
140631110,14,63,11,10,518,545,1063
140631111,14,63,11,11,281,338,619
140631112,14,63,11,12,156,250,406
140631113,14,63,11,13,339,398,737
140631114,14,63,11,14,229,326,555
140631115,14,63,11,15,290,297,587
140631116,14,63,11,16,546,544,1090
140631201,14,63,12,1,347,352,699
140631202,14,63,12,2,272,280,552
140631203,14,63,12,3,364,366,730
140631204,14,63,12,4,184,232,416
140631205,14,63,12,5,482,537,1019
140631206,14,63,12,6,467,480,947
140631207,14,63,12,7,363,417,780
140631208,14,63,12,8,305,401,706
140631209,14,63,12,9,574,594,1168
140631210,14,63,12,10,665,666,1331
140631211,14,63,12,11,464,475,939
140631212,14,63,12,12,430,457,887
140631213,14,63,12,13,388,404,792
140631214,14,63,12,14,521,572,1093
140631215,14,63,12,15,599,563,1162
140631216,14,63,12,16,515,538,1053
140631301,14,63,13,1,562,565,1127
140631302,14,63,13,2,338,311,649
140631303,14,63,13,3,457,491,948
140631304,14,63,13,4,332,355,687
140631305,14,63,13,5,629,655,1284
140631306,14,63,13,6,339,379,718
140631307,14,63,13,7,214,228,442
140631308,14,63,13,8,274,346,620
140631309,14,63,13,9,386,486,872
140631310,14,63,13,10,215,226,441
140631311,14,63,13,11,285,325,610
140631312,14,63,13,12,295,297,592
140631313,14,63,13,13,289,287,576
140631314,14,63,13,14,413,428,841
140700101,14,70,1,1,159,144,303
140700102,14,70,1,2,66,67,133
140700103,14,70,1,3,174,164,338
140700104,14,70,1,4,71,48,119
140700105,14,70,1,5,179,148,327
140700201,14,70,2,1,75,73,148
140700202,14,70,2,2,77,67,144
140700203,14,70,2,3,167,126,293
140700204,14,70,2,4,57,38,95
140700205,14,70,2,5,98,83,181
140700206,14,70,2,6,150,127,277
140700207,14,70,2,7,112,132,244
140700208,14,70,2,8,69,64,133
140700209,14,70,2,9,70,65,135
140700210,14,70,2,10,119,124,243
140700211,14,70,2,11,147,156,303
140700212,14,70,2,12,231,214,445
140700213,14,70,2,13,412,454,866
140770101,14,77,1,1,28,16,44
140770102,14,77,1,2,14,10,24
140770103,14,77,1,3,69,65,134
140770104,14,77,1,4,55,38,93
140770105,14,77,1,5,86,102,188
140770106,14,77,1,6,88,79,167
140770107,14,77,1,7,71,63,134
140770108,14,77,1,8,59,40,99
140770109,14,77,1,9,65,54,119
140770110,14,77,1,10,210,212,422
140770201,14,77,2,1,96,68,164
140770202,14,77,2,2,157,133,290
140770203,14,77,2,3,250,268,518
140770204,14,77,2,4,396,335,731
140770205,14,77,2,5,79,69,148
140770206,14,77,2,6,26,22,48
140770207,14,77,2,7,96,93,189
140770208,14,77,2,8,93,69,162
140770209,14,77,2,9,47,30,77
140770210,14,77,2,10,333,347,680
140770211,14,77,2,11,277,318,595
140770212,14,77,2,12,88,95,183
140770213,14,77,2,13,86,85,171
140840101,14,84,1,1,71,56,127
140840102,14,84,1,2,90,68,158
140840103,14,84,1,3,80,55,135
140840104,14,84,1,4,39,22,61
140840105,14,84,1,5,43,18,61
140840106,14,84,1,6,527,537,1064
140840107,14,84,1,7,300,343,643
140840108,14,84,1,8,560,551,1111
140840109,14,84,1,9,476,485,961
140840110,14,84,1,10,411,445,856
140840111,14,84,1,11,541,521,1062
140840201,14,84,2,1,42,26,68
140840202,14,84,2,2,45,25,70
140840203,14,84,2,3,32,38,70
140840204,14,84,2,4,79,68,147
140840205,14,84,2,5,48,30,78
140840206,14,84,2,6,95,84,179
140840207,14,84,2,7,86,60,146
140840208,14,84,2,8,69,53,122
140840209,14,84,2,9,179,194,373
140840210,14,84,2,10,430,395,825
140840301,14,84,3,1,49,38,87
140840302,14,84,3,2,101,76,177
140840303,14,84,3,3,44,44,88
140840304,14,84,3,4,43,34,77
140840305,14,84,3,5,74,56,130
140840306,14,84,3,6,44,35,79
140840307,14,84,3,7,47,45,92
140840308,14,84,3,8,59,27,86
140840309,14,84,3,9,45,23,68
140840310,14,84,3,10,40,22,62
140840311,14,84,3,11,29,25,54
140840312,14,84,3,12,44,34,78
140840313,14,84,3,13,301,297,598
140840314,14,84,3,14,374,346,720
140840315,14,84,3,15,268,257,525
140840316,14,84,3,16,250,258,508
140840401,14,84,4,1,66,29,95
140840402,14,84,4,2,105,69,174
140840403,14,84,4,3,24,21,45
140840404,14,84,4,4,118,124,242
140840405,14,84,4,5,158,126,284
140840406,14,84,4,6,270,314,584
140840407,14,84,4,7,307,340,647
140840408,14,84,4,8,479,478,957
140840409,14,84,4,9,501,473,974
140840501,14,84,5,1,476,480,956
140840502,14,84,5,2,324,367,691
140840503,14,84,5,3,362,379,741
140840504,14,84,5,4,566,569,1135
140840505,14,84,5,5,432,451,883
140840506,14,84,5,6,374,391,765
140840507,14,84,5,7,384,401,785
140840508,14,84,5,8,452,533,985
140840509,14,84,5,9,307,341,648
140840510,14,84,5,10,248,289,537
140840511,14,84,5,11,335,387,722
140840512,14,84,5,12,477,504,981
140840513,14,84,5,13,343,382,725
140840514,14,84,5,14,517,551,1068
140840515,14,84,5,15,290,353,643
140840516,14,84,5,16,324,422,746
140840517,14,84,5,17,267,299,566
140840518,14,84,5,18,326,366,692
140840519,14,84,5,19,360,353,713
140840520,14,84,5,20,249,278,527
140840521,14,84,5,21,428,492,920
140840522,14,84,5,22,313,377,690
140840523,14,84,5,23,390,438,828
140840524,14,84,5,24,388,377,765
140840525,14,84,5,25,270,308,578
140840526,14,84,5,26,342,345,687
140840527,14,84,5,27,278,279,557
140910101,14,91,1,1,419,417,836
140910102,14,91,1,2,206,249,455
140910103,14,91,1,3,282,335,617
140910104,14,91,1,4,301,331,632
140910105,14,91,1,5,136,143,279
140910106,14,91,1,6,288,369,657
140910107,14,91,1,7,356,401,757
140910108,14,91,1,8,281,395,676
140910109,14,91,1,9,213,244,457
140910110,14,91,1,10,241,282,523
140910111,14,91,1,11,250,283,533
140910112,14,91,1,12,274,290,564
140910113,14,91,1,13,368,411,779
140910114,14,91,1,14,409,462,871
140910115,14,91,1,15,164,181,345
140910116,14,91,1,16,308,329,637
140910117,14,91,1,17,212,232,444
140910118,14,91,1,18,335,354,689
140910119,14,91,1,19,201,229,430
140910201,14,91,2,1,161,160,321
140910202,14,91,2,2,82,58,140
140910203,14,91,2,3,107,94,201
140910204,14,91,2,4,81,75,156
140910205,14,91,2,5,11,7,18
140910206,14,91,2,6,47,35,82
140910207,14,91,2,7,4,2,6
140910208,14,91,2,8,15,10,25
140910209,14,91,2,9,416,436,852
140910210,14,91,2,10,440,500,940
140910211,14,91,2,11,147,155,302
140910212,14,91,2,12,3,2,5
140910301,14,91,3,1,12,12,24
140910302,14,91,3,2,34,24,58
140910303,14,91,3,3,422,446,868
140910304,14,91,3,4,476,514,990
140910305,14,91,3,5,330,356,686
140910306,14,91,3,6,280,271,551
140910307,14,91,3,7,369,420,789
140910308,14,91,3,8,385,374,759
140910309,14,91,3,9,364,454,818
140910310,14,91,3,10,284,308,592
140910311,14,91,3,11,317,332,649
140910401,14,91,4,1,522,537,1059
140910402,14,91,4,2,433,512,945
140910403,14,91,4,3,321,397,718
140910404,14,91,4,4,454,490,944
140910405,14,91,4,5,310,424,734
140910406,14,91,4,6,308,387,695
140910407,14,91,4,7,506,610,1116
140910408,14,91,4,8,349,370,719
140910409,14,91,4,9,413,524,937
140910410,14,91,4,10,182,264,446
140910411,14,91,4,11,411,509,920
140910412,14,91,4,12,137,159,296
140910413,14,91,4,13,445,550,995
140910414,14,91,4,14,267,318,585
140910415,14,91,4,15,430,443,873
140910416,14,91,4,16,259,279,538
140910417,14,91,4,17,608,710,1318
140910418,14,91,4,18,355,401,756
140910419,14,91,4,19,334,361,695
140910420,14,91,4,20,521,525,1046
140910501,14,91,5,1,10,8,18
140910502,14,91,5,2,270,280,550
140910503,14,91,5,3,358,410,768
140910504,14,91,5,4,468,497,965
140910505,14,91,5,5,504,533,1037
140910506,14,91,5,6,306,385,691
140910507,14,91,5,7,261,300,561
140910508,14,91,5,8,149,174,323
140910509,14,91,5,9,295,303,598
140910510,14,91,5,10,341,353,694
140910601,14,91,6,1,2,2,4
140910602,14,91,6,2,196,203,399
140910603,14,91,6,3,38,31,69
140910604,14,91,6,4,29,31,60
140910605,14,91,6,5,28,31,59
140910606,14,91,6,6,428,445,873
140910607,14,91,6,7,463,519,982
140910608,14,91,6,8,578,556,1134
140910609,14,91,6,9,241,274,515
140910610,14,91,6,10,462,525,987
140910611,14,91,6,11,311,371,682
140910612,14,91,6,12,317,325,642
140910613,14,91,6,13,363,399,762
140910614,14,91,6,14,287,276,563
140910615,14,91,6,15,245,281,526
140910616,14,91,6,16,240,279,519
140910617,14,91,6,17,309,369,678
140910618,14,91,6,18,342,321,663
140910701,14,91,7,1,49,51,100
140910702,14,91,7,2,348,338,686
140910703,14,91,7,3,464,506,970
140910704,14,91,7,4,330,369,699
140910705,14,91,7,5,257,303,560
140910706,14,91,7,6,227,229,456
140910707,14,91,7,7,369,443,812
140910708,14,91,7,8,337,410,747
140910709,14,91,7,9,427,510,937
140910710,14,91,7,10,205,247,452
140910711,14,91,7,11,381,487,868
140910712,14,91,7,12,356,417,773
140910713,14,91,7,13,638,712,1350
140910714,14,91,7,14,423,425,848
140910715,14,91,7,15,491,628,1119
140910716,14,91,7,16,349,434,783
140910717,14,91,7,17,298,287,585
140910718,14,91,7,18,430,480,910
140910719,14,91,7,19,265,286,551
140910720,14,91,7,20,614,652,1266
140910721,14,91,7,21,696,754,1450
140910722,14,91,7,22,584,612,1196
140910723,14,91,7,23,458,466,924
140910801,14,91,8,1,10,5,15
140910802,14,91,8,2,126,107,233
140910803,14,91,8,3,10,6,16
140910804,14,91,8,4,169,174,343
140910805,14,91,8,5,255,306,561
140910806,14,91,8,6,303,326,629
140910807,14,91,8,7,282,288,570
140910808,14,91,8,8,230,200,430
140910809,14,91,8,9,315,314,629
140910810,14,91,8,10,375,398,773
140910811,14,91,8,11,241,296,537
140910812,14,91,8,12,492,524,1016
140910813,14,91,8,13,555,511,1066
140910901,14,91,9,1,417,437,854
140910902,14,91,9,2,273,262,535
140910903,14,91,9,3,278,339,617
140910904,14,91,9,4,618,599,1217
140910905,14,91,9,5,574,626,1200
140910906,14,91,9,6,504,547,1051
140910907,14,91,9,7,398,419,817
140910908,14,91,9,8,361,431,792
140910909,14,91,9,9,396,425,821
140910910,14,91,9,10,208,281,489
140910911,14,91,9,11,122,169,291
140910912,14,91,9,12,315,309,624
140910913,14,91,9,13,378,377,755
140910914,14,91,9,14,516,534,1050
140910915,14,91,9,15,574,594,1168
140910916,14,91,9,16,617,590,1207
140910917,14,91,9,17,400,469,869
140910918,14,91,9,18,297,295,592
140910919,14,91,9,19,309,364,673
140910920,14,91,9,20,400,460,860
140910921,14,91,9,21,793,860,1653
140910922,14,91,9,22,730,786,1516
140910923,14,91,9,23,0,0,0
140911001,14,91,10,1,441,498,939
140911002,14,91,10,2,320,390,710
140911003,14,91,10,3,332,381,713
140911004,14,91,10,4,443,571,1014
140911005,14,91,10,5,396,421,817
140911006,14,91,10,6,428,456,884
140911007,14,91,10,7,305,301,606
140911008,14,91,10,8,412,478,890
140911009,14,91,10,9,279,319,598
140911010,14,91,10,10,355,355,710
140911011,14,91,10,11,310,352,662
140911012,14,91,10,12,276,333,609
140911013,14,91,10,13,393,486,879
140911014,14,91,10,14,241,253,494
140911015,14,91,10,15,290,350,640
140911016,14,91,10,16,297,380,677
140911017,14,91,10,17,302,371,673
140911018,14,91,10,18,315,377,692
140911019,14,91,10,19,245,287,532
140911020,14,91,10,20,155,158,313
140911101,14,91,11,1,301,358,659
140911102,14,91,11,2,230,358,588
140911103,14,91,11,3,305,345,650
140911104,14,91,11,4,266,365,631
140911105,14,91,11,5,470,495,965
140911106,14,91,11,6,106,130,236
140911107,14,91,11,7,139,178,317
140911108,14,91,11,8,233,246,479
140911109,14,91,11,9,389,513,902
140911110,14,91,11,10,369,465,834
140911111,14,91,11,11,132,197,329
140911112,14,91,11,12,366,375,741
140911113,14,91,11,13,292,328,620
140911114,14,91,11,14,236,286,522
140911115,14,91,11,15,265,294,559
140911116,14,91,11,16,247,273,520
140911117,14,91,11,17,265,304,569
140911118,14,91,11,18,294,299,593
140911201,14,91,12,1,431,454,885
140911202,14,91,12,2,295,343,638
140911203,14,91,12,3,345,379,724
140911204,14,91,12,4,432,493,925
140911205,14,91,12,5,453,502,955
140911206,14,91,12,6,280,283,563
140911207,14,91,12,7,469,498,967
140911208,14,91,12,8,605,679,1284
140911209,14,91,12,9,333,355,688
140911210,14,91,12,10,484,469,953
140911211,14,91,12,11,467,507,974
140911212,14,91,12,12,280,303,583
140911213,14,91,12,13,331,362,693
140911214,14,91,12,14,431,488,919
140911215,14,91,12,15,472,462,934
140911216,14,91,12,16,199,195,394
140911217,14,91,12,17,270,296,566
140911218,14,91,12,18,287,299,586
140911219,14,91,12,19,394,446,840
140911220,14,91,12,20,328,379,707
140911221,14,91,12,21,378,410,788
140911222,14,91,12,22,365,376,741
140911223,14,91,12,23,349,350,699
140911301,14,91,13,1,8,3,11
140911302,14,91,13,2,28,16,44
140911303,14,91,13,3,43,36,79
140911304,14,91,13,4,7,8,15
140911305,14,91,13,5,6,10,16
140911306,14,91,13,6,14,11,25
140911307,14,91,13,7,9,9,18
140911308,14,91,13,8,8,7,15
140911309,14,91,13,9,206,179,385
140911310,14,91,13,10,150,137,287
140911311,14,91,13,11,500,512,1012
140911312,14,91,13,12,269,296,565
140911313,14,91,13,13,423,411,834
140911314,14,91,13,14,219,206,425
140911315,14,91,13,15,400,432,832
140911316,14,91,13,16,146,160,306
140911317,14,91,13,17,158,183,341
140911318,14,91,13,18,175,203,378
140911319,14,91,13,19,146,175,321
140911320,14,91,13,20,147,157,304
140911321,14,91,13,21,152,139,291
140911322,14,91,13,22,124,131,255
140911323,14,91,13,23,324,301,625
140911401,14,91,14,1,24,18,42
140911402,14,91,14,2,36,41,77
140911403,14,91,14,3,16,15,31
140911404,14,91,14,4,46,26,72
140911405,14,91,14,5,59,39,98
140911406,14,91,14,6,245,251,496
140911407,14,91,14,7,401,439,840
140911408,14,91,14,8,310,380,690
140911409,14,91,14,9,433,492,925
140911410,14,91,14,10,573,619,1192
140911411,14,91,14,11,291,336,627
140911412,14,91,14,12,321,353,674
140911413,14,91,14,13,342,403,745
140911414,14,91,14,14,293,406,699
140911415,14,91,14,15,299,357,656
140911501,14,91,15,1,10,8,18
140911502,14,91,15,2,232,258,490
140911503,14,91,15,3,362,352,714
140911504,14,91,15,4,279,321,600
140911505,14,91,15,5,234,259,493
140911506,14,91,15,6,273,304,577
140911507,14,91,15,7,382,381,763
140911508,14,91,15,8,331,358,689
140911509,14,91,15,9,360,405,765
140911510,14,91,15,10,398,436,834
140911601,14,91,16,1,12,6,18
140911602,14,91,16,2,26,17,43
140911603,14,91,16,3,4,6,10
140911604,14,91,16,4,10,8,18
140911605,14,91,16,5,112,87,199
140911606,14,91,16,6,42,45,87
140911607,14,91,16,7,9,13,22
140911608,14,91,16,8,232,314,546
140911609,14,91,16,9,218,205,423
140911610,14,91,16,10,126,123,249
140911701,14,91,17,1,2,1,3
140911702,14,91,17,2,5,3,8
140911703,14,91,17,3,16,16,32
140911704,14,91,17,4,1,2,3
140911705,14,91,17,5,10,8,18
140911706,14,91,17,6,403,410,813
140911707,14,91,17,7,273,287,560
140911708,14,91,17,8,246,263,509
140911709,14,91,17,9,319,337,656
140911710,14,91,17,10,222,228,450
140911711,14,91,17,11,216,243,459
140911712,14,91,17,12,207,232,439
140911713,14,91,17,13,377,390,767
140911714,14,91,17,14,236,233,469
140911715,14,91,17,15,155,148,303
140911801,14,91,18,1,24,21,45
140911802,14,91,18,2,10,10,20
140911803,14,91,18,3,27,21,48
140911804,14,91,18,4,193,170,363
140911805,14,91,18,5,93,88,181
140911806,14,91,18,6,169,167,336
140911807,14,91,18,7,142,140,282
140911808,14,91,18,8,309,318,627
140911809,14,91,18,9,278,232,510
140911810,14,91,18,10,78,53,131
140911901,14,91,19,1,76,74,150
140911902,14,91,19,2,45,49,94
140911903,14,91,19,3,1,1,2
140911904,14,91,19,4,54,25,79
140911905,14,91,19,5,20,11,31
140911906,14,91,19,6,300,283,583
140911907,14,91,19,7,256,220,476
140911908,14,91,19,8,353,326,679
140911909,14,91,19,9,329,350,679
140911910,14,91,19,10,358,316,674
140911911,14,91,19,11,450,479,929
140911912,14,91,19,12,61,47,108
140911913,14,91,19,13,331,333,664
140911914,14,91,19,14,230,232,462
140980101,14,98,1,1,8,6,14
140980102,14,98,1,2,32,25,57
140980103,14,98,1,3,59,44,103
140980104,14,98,1,4,50,30,80
140980105,14,98,1,5,20,17,37
140980106,14,98,1,6,35,28,63
140980107,14,98,1,7,19,22,41
140980108,14,98,1,8,256,259,515
140980109,14,98,1,9,360,380,740
140980110,14,98,1,10,431,446,877
140980111,14,98,1,11,269,337,606
140980112,14,98,1,12,262,281,543
140980113,14,98,1,13,273,329,602
140980114,14,98,1,14,331,335,666
140980115,14,98,1,15,367,396,763
140980116,14,98,1,16,292,346,638
140980117,14,98,1,17,444,475,919
140980201,14,98,2,1,20,11,31
140980202,14,98,2,2,62,47,109
140980203,14,98,2,3,135,111,246
140980204,14,98,2,4,76,66,142
140980205,14,98,2,5,56,44,100
140980206,14,98,2,6,33,20,53
140980207,14,98,2,7,27,30,57
140980208,14,98,2,8,316,361,677
140980209,14,98,2,9,286,283,569
140980210,14,98,2,10,374,373,747
140980211,14,98,2,11,464,528,992
140980301,14,98,3,1,32,23,55
140980302,14,98,3,2,51,42,93
140980303,14,98,3,3,21,13,34
140980304,14,98,3,4,320,358,678
140980305,14,98,3,5,479,469,948
140980306,14,98,3,6,382,457,839
140980307,14,98,3,7,232,320,552
140980308,14,98,3,8,376,426,802
140980309,14,98,3,9,316,331,647
140980310,14,98,3,10,305,305,610
140980311,14,98,3,11,391,452,843
140980401,14,98,4,1,43,24,67
140980402,14,98,4,2,97,78,175
140980403,14,98,4,3,47,33,80
140980404,14,98,4,4,32,25,57
140980405,14,98,4,5,34,31,65
140980406,14,98,4,6,73,69,142
140980407,14,98,4,7,353,366,719
140980408,14,98,4,8,367,370,737
140980409,14,98,4,9,143,161,304
140980501,14,98,5,1,32,21,53
140980502,14,98,5,2,100,83,183
140980503,14,98,5,3,36,36,72
140980504,14,98,5,4,17,12,29
140980505,14,98,5,5,183,171,354
140980506,14,98,5,6,354,258,612
140980507,14,98,5,7,71,48,119
140980508,14,98,5,8,35,24,59
140980509,14,98,5,9,83,75,158
140980510,14,98,5,10,456,454,910
140980511,14,98,5,11,364,369,733
140980512,14,98,5,12,455,459,914
140980513,14,98,5,13,322,350,672
140980514,14,98,5,14,283,286,569
140980515,14,98,5,15,352,365,717
140980516,14,98,5,16,202,199,401
140980517,14,98,5,17,401,368,769
140980601,14,98,6,1,38,32,70
140980602,14,98,6,2,108,72,180
140980603,14,98,6,3,81,60,141
140980604,14,98,6,4,61,44,105
140980605,14,98,6,5,69,57,126
140980606,14,98,6,6,96,83,179
140980607,14,98,6,7,108,113,221
140980608,14,98,6,8,144,132,276
140980609,14,98,6,9,72,64,136
140980701,14,98,7,1,48,29,77
140980702,14,98,7,2,85,62,147
140980703,14,98,7,3,77,67,144
140980704,14,98,7,4,134,102,236
140980705,14,98,7,5,29,26,55
140980706,14,98,7,6,46,35,81
140980707,14,98,7,7,77,73,150
140980708,14,98,7,8,67,70,137
140980801,14,98,8,1,90,60,150
140980802,14,98,8,2,94,64,158
140980803,14,98,8,3,105,94,199
140980804,14,98,8,4,130,84,214
140980805,14,98,8,5,32,18,50
140980806,14,98,8,6,121,97,218
140980807,14,98,8,7,208,260,468
140980808,14,98,8,8,361,406,767
140980809,14,98,8,9,297,309,606
140980810,14,98,8,10,227,219,446
140980811,14,98,8,11,151,141,292
140980901,14,98,9,1,78,61,139
140980902,14,98,9,2,246,201,447
140980903,14,98,9,3,111,74,185
140980904,14,98,9,4,306,362,668
140980905,14,98,9,5,318,347,665
140980906,14,98,9,6,364,396,760
140980907,14,98,9,7,288,349,637
140980908,14,98,9,8,325,349,674
140980909,14,98,9,9,402,388,790
140980910,14,98,9,10,313,333,646
140980911,14,98,9,11,168,157,325
140980912,14,98,9,12,532,567,1099
140980913,14,98,9,13,312,380,692
140980914,14,98,9,14,370,390,760
140981001,14,98,10,1,19,20,39
140981002,14,98,10,2,33,25,58
140981003,14,98,10,3,318,294,612
140981004,14,98,10,4,82,70,152
140981005,14,98,10,5,76,73,149
140981006,14,98,10,6,64,38,102
140981007,14,98,10,7,104,93,197
140981008,14,98,10,8,114,96,210
140981009,14,98,10,9,308,274,582
140981010,14,98,10,10,309,300,609
140981011,14,98,10,11,505,557,1062
140981012,14,98,10,12,302,368,670
140981013,14,98,10,13,452,485,937
140981014,14,98,10,14,381,385,766
140981101,14,98,11,1,148,109,257
140981102,14,98,11,2,161,122,283
140981103,14,98,11,3,37,28,65
140981104,14,98,11,4,33,21,54
140981105,14,98,11,5,51,50,101
140981106,14,98,11,6,215,127,342
140981107,14,98,11,7,108,87,195
140981108,14,98,11,8,72,43,115
140981109,14,98,11,9,406,426,832
140981110,14,98,11,10,304,300,604
140981111,14,98,11,11,379,386,765
140981201,14,98,12,1,140,111,251
140981202,14,98,12,2,161,113,274
140981203,14,98,12,3,229,182,411
140981204,14,98,12,4,249,172,421
140981205,14,98,12,5,68,50,118
140981206,14,98,12,6,198,170,368
140981207,14,98,12,7,456,427,883
140981208,14,98,12,8,329,328,657
140981209,14,98,12,9,267,268,535
140981210,14,98,12,10,266,293,559
140981211,14,98,12,11,254,272,526
140981212,14,98,12,12,331,344,675
140981301,14,98,13,1,91,50,141
140981302,14,98,13,2,86,49,135
140981303,14,98,13,3,72,71,143
140981304,14,98,13,4,76,55,131
140981305,14,98,13,5,58,27,85
140981306,14,98,13,6,53,25,78
140981307,14,98,13,7,18,9,27
140981308,14,98,13,8,64,46,110
140981309,14,98,13,9,104,40,144
140981310,14,98,13,10,97,50,147
140981311,14,98,13,11,390,377,767
140981312,14,98,13,12,508,543,1051
140981313,14,98,13,13,317,291,608
140981401,14,98,14,1,106,89,195
140981402,14,98,14,2,83,43,126
140981403,14,98,14,3,82,29,111
140981404,14,98,14,4,99,73,172
140981405,14,98,14,5,99,68,167
140981406,14,98,14,6,71,55,126
140981407,14,98,14,7,71,33,104
140981408,14,98,14,8,90,20,110
140981409,14,98,14,9,215,199,414
140981410,14,98,14,10,518,451,969
140981501,14,98,15,1,550,527,1077
140981502,14,98,15,2,575,547,1122
140981503,14,98,15,3,629,660,1289
140981504,14,98,15,4,489,493,982
140981505,14,98,15,5,405,381,786
140981506,14,98,15,6,385,396,781
140981507,14,98,15,7,400,416,816
140981508,14,98,15,8,358,375,733
140981509,14,98,15,9,519,576,1095
140981510,14,98,15,10,544,559,1103
140981511,14,98,15,11,515,442,957
140981512,14,98,15,12,301,310,611
140981513,14,98,15,13,532,563,1095
140981514,14,98,15,14,439,529,968
140981515,14,98,15,15,270,369,639
140981601,14,98,16,1,491,482,973
140981602,14,98,16,2,666,642,1308
140981603,14,98,16,3,301,314,615
140981604,14,98,16,4,324,354,678
140981605,14,98,16,5,519,599,1118
140981606,14,98,16,6,264,304,568
140981607,14,98,16,7,368,385,753
140981608,14,98,16,8,342,361,703
140981609,14,98,16,9,688,770,1458
140981610,14,98,16,10,571,627,1198
140981611,14,98,16,11,340,419,759
140981612,14,98,16,12,319,432,751
140981613,14,98,16,13,175,229,404
140981614,14,98,16,14,173,234,407
140981615,14,98,16,15,161,229,390
140981701,14,98,17,1,765,792,1557
140981702,14,98,17,2,550,538,1088
140981703,14,98,17,3,456,514,970
140981704,14,98,17,4,336,343,679
140981705,14,98,17,5,567,615,1182
140981706,14,98,17,6,377,380,757
140981707,14,98,17,7,299,346,645
140981708,14,98,17,8,518,547,1065
140981709,14,98,17,9,413,458,871
140981710,14,98,17,10,387,397,784
140981711,14,98,17,11,433,496,929
140981712,14,98,17,12,679,735,1414
140981713,14,98,17,13,403,430,833
140981801,14,98,18,1,610,647,1257
140981802,14,98,18,2,598,633,1231
140981803,14,98,18,3,738,782,1520
140981804,14,98,18,4,664,757,1421
140981805,14,98,18,5,617,705,1322
140981806,14,98,18,6,452,534,986
140981807,14,98,18,7,481,488,969
140981808,14,98,18,8,562,546,1108
140981809,14,98,18,9,717,777,1494
140981810,14,98,18,10,644,675,1319
140981811,14,98,18,11,452,475,927
140981812,14,98,18,12,457,494,951
140981813,14,98,18,13,519,535,1054
140981901,14,98,19,1,332,352,684
140981902,14,98,19,2,1201,1140,2341
140981903,14,98,19,3,602,601,1203
140981904,14,98,19,4,459,436,895
140981905,14,98,19,5,390,405,795
140981906,14,98,19,6,424,418,842
140981907,14,98,19,7,419,423,842
140981908,14,98,19,8,446,490,936
140981909,14,98,19,9,311,360,671
140981910,14,98,19,10,303,368,671
140981911,14,98,19,11,422,502,924
140981912,14,98,19,12,512,529,1041
140982001,14,98,20,1,151,173,324
140982002,14,98,20,2,255,322,577
140982003,14,98,20,3,308,380,688
140982004,14,98,20,4,164,227,391
140982005,14,98,20,5,119,177,296
140982006,14,98,20,6,323,453,776
140982007,14,98,20,7,222,319,541
140982008,14,98,20,8,410,517,927
140982009,14,98,20,9,318,372,690
140982010,14,98,20,10,370,390,760
140982011,14,98,20,11,158,201,359
140982012,14,98,20,12,218,273,491
140982013,14,98,20,13,170,273,443
140982014,14,98,20,14,195,291,486
140982015,14,98,20,15,164,204,368
140982016,14,98,20,16,245,337,582
140982017,14,98,20,17,299,428,727
140982018,14,98,20,18,330,473,803
140982019,14,98,20,19,84,134,218
140982020,14,98,20,20,164,235,399
140982021,14,98,20,21,189,266,455
140982022,14,98,20,22,222,271,493
140982101,14,98,21,1,492,485,977
140982102,14,98,21,2,299,350,649
140982103,14,98,21,3,556,631,1187
140982104,14,98,21,4,310,375,685
140982105,14,98,21,5,302,362,664
140982106,14,98,21,6,230,273,503
140982107,14,98,21,7,234,290,524
140982108,14,98,21,8,404,511,915
140982109,14,98,21,9,374,465,839
140982110,14,98,21,10,485,525,1010
140982111,14,98,21,11,477,527,1004
140982112,14,98,21,12,459,472,931
140982113,14,98,21,13,510,519,1029
140982114,14,98,21,14,576,566,1142
140982201,14,98,22,1,624,685,1309
140982202,14,98,22,2,525,645,1170
140982203,14,98,22,3,529,573,1102
140982204,14,98,22,4,351,366,717
140982205,14,98,22,5,555,627,1182
140982206,14,98,22,6,534,541,1075
140982207,14,98,22,7,526,648,1174
140982208,14,98,22,8,597,566,1163
140982209,14,98,22,9,488,451,939
140982210,14,98,22,10,657,647,1304
140982211,14,98,22,11,566,564,1130
140982212,14,98,22,12,431,403,834
140982301,14,98,23,1,460,517,977
140982302,14,98,23,2,396,380,776
140982303,14,98,23,3,307,371,678
140982304,14,98,23,4,618,652,1270
140982305,14,98,23,5,222,264,486
140982306,14,98,23,6,342,400,742
140982307,14,98,23,7,651,319,970
140982308,14,98,23,8,496,534,1030
140982309,14,98,23,9,423,453,876
140982310,14,98,23,10,429,443,872
140982311,14,98,23,11,433,433,866
140982312,14,98,23,12,656,694,1350
140982313,14,98,23,13,532,566,1098
140982314,14,98,23,14,418,405,823
140982401,14,98,24,1,309,388,697
140982402,14,98,24,2,180,260,440
140982403,14,98,24,3,157,204,361
140982404,14,98,24,4,400,460,860
140982405,14,98,24,5,408,459,867
140982406,14,98,24,6,388,501,889
140982407,14,98,24,7,155,236,391
140982408,14,98,24,8,222,329,551
140982409,14,98,24,9,329,394,723
140982410,14,98,24,10,325,396,721
140982411,14,98,24,11,349,447,796
140982412,14,98,24,12,370,442,812
140982413,14,98,24,13,378,440,818
140982414,14,98,24,14,414,479,893
140982415,14,98,24,15,217,324,541
140982416,14,98,24,16,319,396,715
140982417,14,98,24,17,364,433,797
140982418,14,98,24,18,269,329,598
140982419,14,98,24,19,182,230,412
140982420,14,98,24,20,426,500,926
140982421,14,98,24,21,317,369,686
140982501,14,98,25,1,421,448,869
140982502,14,98,25,2,486,587,1073
140982503,14,98,25,3,407,456,863
140982504,14,98,25,4,402,485,887
140982505,14,98,25,5,599,654,1253
140982506,14,98,25,6,622,672,1294
140982507,14,98,25,7,684,669,1353
140982508,14,98,25,8,596,635,1231
140982509,14,98,25,9,378,402,780
140982510,14,98,25,10,348,408,756
140982511,14,98,25,11,768,780,1548
140982512,14,98,25,12,775,820,1595
140982601,14,98,26,1,409,464,873
140982602,14,98,26,2,434,458,892
140982603,14,98,26,3,722,748,1470
140982604,14,98,26,4,554,562,1116
140982605,14,98,26,5,514,528,1042
140982606,14,98,26,6,385,439,824
140982607,14,98,26,7,465,511,976
140982608,14,98,26,8,524,566,1090
140982609,14,98,26,9,454,488,942
140982610,14,98,26,10,480,501,981
140982611,14,98,26,11,471,486,957
140982612,14,98,26,12,541,566,1107
140982613,14,98,26,13,326,337,663
140982701,14,98,27,1,663,611,1274
140982702,14,98,27,2,662,634,1296
140982703,14,98,27,3,501,537,1038
140982704,14,98,27,4,257,296,553
140982705,14,98,27,5,387,400,787
140982706,14,98,27,6,352,370,722
140982707,14,98,27,7,456,491,947
140982708,14,98,27,8,452,517,969
140982801,14,98,28,1,586,629,1215
140982802,14,98,28,2,460,507,967
140982803,14,98,28,3,224,275,499
140982804,14,98,28,4,243,289,532
140982805,14,98,28,5,325,334,659
140982806,14,98,28,6,439,418,857
140982807,14,98,28,7,409,398,807
140982808,14,98,28,8,218,274,492
140982809,14,98,28,9,369,412,781
140982810,14,98,28,10,359,387,746
140982811,14,98,28,11,307,308,615
140982812,14,98,28,12,412,423,835
140982901,14,98,29,1,411,429,840
140982902,14,98,29,2,468,477,945
140982903,14,98,29,3,220,230,450
140982904,14,98,29,4,331,323,654
140982905,14,98,29,5,333,332,665
140982906,14,98,29,6,335,344,679
140982907,14,98,29,7,177,196,373
140982908,14,98,29,8,211,232,443
140982909,14,98,29,9,285,294,579
140982910,14,98,29,10,397,432,829
140982911,14,98,29,11,387,394,781
140982912,14,98,29,12,400,421,821
140982913,14,98,29,13,460,485,945
140982914,14,98,29,14,511,506,1017
141050101,14,105,1,1,129,124,253
141050102,14,105,1,2,57,65,122
141050103,14,105,1,3,185,186,371
141050104,14,105,1,4,66,51,117
141050105,14,105,1,5,26,24,50
141050106,14,105,1,6,145,108,253
141050107,14,105,1,7,74,72,146
141050108,14,105,1,8,151,121,272
141050109,14,105,1,9,201,182,383
141050110,14,105,1,10,134,134,268
141050111,14,105,1,11,124,108,232
141050112,14,105,1,12,308,347,655
141050113,14,105,1,13,392,409,801
141050114,14,105,1,14,446,518,964
141050201,14,105,2,1,44,32,76
141050202,14,105,2,2,26,32,58
141050203,14,105,2,3,133,107,240
141050204,14,105,2,4,56,49,105
141050205,14,105,2,5,148,127,275
141050206,14,105,2,6,127,87,214
141050207,14,105,2,7,39,33,72
141050208,14,105,2,8,116,109,225
141050209,14,105,2,9,70,64,134
141050210,14,105,2,10,224,245,469
141050211,14,105,2,11,409,398,807
141050212,14,105,2,12,341,353,694
141050213,14,105,2,13,304,307,611
141050214,14,105,2,14,395,428,823
141050215,14,105,2,15,455,483,938
141050216,14,105,2,16,556,565,1121
141050217,14,105,2,17,533,531,1064
141050301,14,105,3,1,31,27,58
141050302,14,105,3,2,84,71,155
141050303,14,105,3,3,104,85,189
141050304,14,105,3,4,33,36,69
141050305,14,105,3,5,210,171,381
141050306,14,105,3,6,96,78,174
141050307,14,105,3,7,72,43,115
141050308,14,105,3,8,240,269,509
141050309,14,105,3,9,599,599,1198
141050310,14,105,3,10,469,501,970
141050311,14,105,3,11,257,278,535
141050312,14,105,3,12,403,428,831
141050313,14,105,3,13,599,605,1204
141050314,14,105,3,14,510,567,1077
141050315,14,105,3,15,529,581,1110
141050316,14,105,3,16,377,459,836
141050401,14,105,4,1,21,18,39
141050402,14,105,4,2,92,69,161
141050403,14,105,4,3,42,35,77
141050404,14,105,4,4,97,74,171
141050405,14,105,4,5,99,62,161
141050406,14,105,4,6,115,84,199
141050407,14,105,4,7,127,125,252
141050408,14,105,4,8,51,45,96
141050409,14,105,4,9,69,70,139
141050410,14,105,4,10,155,144,299
141050411,14,105,4,11,42,41,83
141050412,14,105,4,12,84,76,160
141050413,14,105,4,13,56,44,100
141050414,14,105,4,14,275,281,556
141050415,14,105,4,15,401,390,791
141050416,14,105,4,16,146,141,287
141050501,14,105,5,1,78,61,139
141050502,14,105,5,2,197,168,365
141050503,14,105,5,3,439,360,799
141050504,14,105,5,4,388,254,642
141050505,14,105,5,5,652,662,1314
141050506,14,105,5,6,388,420,808
141050507,14,105,5,7,383,412,795
141050508,14,105,5,8,540,575,1115
141050509,14,105,5,9,418,433,851
141050510,14,105,5,10,466,533,999
141050511,14,105,5,11,318,364,682
141050512,14,105,5,12,385,399,784
141050513,14,105,5,13,224,241,465
141050514,14,105,5,14,699,742,1441
141050515,14,105,5,15,391,406,797
141050601,14,105,6,1,115,95,210
141050602,14,105,6,2,138,148,286
141050603,14,105,6,3,109,97,206
141050604,14,105,6,4,202,223,425
141050605,14,105,6,5,186,162,348
141050606,14,105,6,6,307,312,619
141050607,14,105,6,7,294,335,629
141050608,14,105,6,8,477,485,962
141050609,14,105,6,9,452,496,948
141050610,14,105,6,10,607,652,1259
141050611,14,105,6,11,608,622,1230
141050612,14,105,6,12,685,712,1397
141050613,14,105,6,13,185,180,365
141120101,14,112,1,1,45,34,79
141120102,14,112,1,2,69,68,137
141120103,14,112,1,3,68,69,137
141120104,14,112,1,4,182,145,327
141120105,14,112,1,5,84,78,162
141120106,14,112,1,6,126,115,241
141120107,14,112,1,7,56,39,95
141120108,14,112,1,8,87,92,179
141120109,14,112,1,9,338,367,705
141120110,14,112,1,10,337,356,693
141120111,14,112,1,11,184,212,396
141120112,14,112,1,12,582,597,1179
141120113,14,112,1,13,308,338,646
141120114,14,112,1,14,180,195,375
141120115,14,112,1,15,317,337,654
141120201,14,112,2,1,329,272,601
141120202,14,112,2,2,44,14,58
141120203,14,112,2,3,45,39,84
141120204,14,112,2,4,43,25,68
141120205,14,112,2,5,42,29,71
141120206,14,112,2,6,110,70,180
141120207,14,112,2,7,273,269,542
141120301,14,112,3,1,55,49,104
141120302,14,112,3,2,143,137,280
141120303,14,112,3,3,67,64,131
141120304,14,112,3,4,325,284,609
141120305,14,112,3,5,137,111,248
141120306,14,112,3,6,178,171,349
141120307,14,112,3,7,100,95,195
141120308,14,112,3,8,60,39,99
141120309,14,112,3,9,122,115,237
141120310,14,112,3,10,339,336,675
141120311,14,112,3,11,352,356,708
141120312,14,112,3,12,473,463,936
141120313,14,112,3,13,399,438,837
141120314,14,112,3,14,111,114,225
141190101,14,119,1,1,544,489,1033
141190102,14,119,1,2,134,112,246
141190103,14,119,1,3,88,90,178
141190104,14,119,1,4,33,24,57
141190105,14,119,1,5,51,41,92
141190106,14,119,1,6,275,312,587
141190107,14,119,1,7,288,342,630
141190108,14,119,1,8,496,562,1058
141190109,14,119,1,9,600,619,1219
141190110,14,119,1,10,200,245,445
141190111,14,119,1,11,356,413,769
141190112,14,119,1,12,488,491,979
141190113,14,119,1,13,346,361,707
141190114,14,119,1,14,511,532,1043
141190115,14,119,1,15,482,479,961
141190201,14,119,2,1,22,20,42
141190202,14,119,2,2,46,35,81
141190203,14,119,2,3,22,12,34
141190204,14,119,2,4,22,16,38
141190205,14,119,2,5,96,63,159
141190206,14,119,2,6,12,10,22
141190207,14,119,2,7,4,2,6
141190208,14,119,2,8,8,8,16
141190209,14,119,2,9,48,38,86
141190210,14,119,2,10,24,23,47
141190211,14,119,2,11,49,47,96
141190212,14,119,2,12,274,243,517
141190213,14,119,2,13,487,485,972
141190214,14,119,2,14,416,403,819
141190215,14,119,2,15,314,347,661
141190301,14,119,3,1,196,183,379
141190302,14,119,3,2,186,142,328
141190303,14,119,3,3,133,118,251
141190304,14,119,3,4,76,62,138
141190305,14,119,3,5,64,63,127
141190306,14,119,3,6,446,471,917
141190307,14,119,3,7,444,515,959
141190308,14,119,3,8,442,461,903
141190309,14,119,3,9,167,161,328
141190310,14,119,3,10,395,362,757
141190311,14,119,3,11,383,385,768
141190312,14,119,3,12,349,331,680
141190313,14,119,3,13,383,367,750
141190314,14,119,3,14,580,646,1226
141190315,14,119,3,15,440,491,931
141190316,14,119,3,16,536,605,1141
141190401,14,119,4,1,29,19,48
141190402,14,119,4,2,52,44,96
141190403,14,119,4,3,32,17,49
141190404,14,119,4,4,58,41,99
141190405,14,119,4,5,40,24,64
141190406,14,119,4,6,74,77,151
141190407,14,119,4,7,122,101,223
141190408,14,119,4,8,111,104,215
141190409,14,119,4,9,262,186,448
141190410,14,119,4,10,603,609,1212
141190411,14,119,4,11,605,618,1223
141190412,14,119,4,12,366,376,742
141190413,14,119,4,13,514,507,1021
141190414,14,119,4,14,436,475,911
141190415,14,119,4,15,311,348,659
141190416,14,119,4,16,347,360,707
141190417,14,119,4,17,328,356,684
141190418,14,119,4,18,515,553,1068
141190419,14,119,4,19,337,396,733
141190420,14,119,4,20,471,447,918
141190501,14,119,5,1,133,115,248
141190502,14,119,5,2,27,26,53
141190503,14,119,5,3,113,106,219
141190504,14,119,5,4,111,101,212
141190505,14,119,5,5,62,52,114
141190506,14,119,5,6,64,54,118
141190507,14,119,5,7,16,9,25
141190508,14,119,5,8,72,49,121
141190509,14,119,5,9,30,17,47
141190510,14,119,5,10,34,27,61
141190511,14,119,5,11,443,460,903
141190512,14,119,5,12,403,442,845
141190513,14,119,5,13,294,345,639
141190514,14,119,5,14,500,459,959
141190515,14,119,5,15,380,379,759
141190601,14,119,6,1,650,678,1328
141190602,14,119,6,2,552,593,1145
141190603,14,119,6,3,474,520,994
141190604,14,119,6,4,342,390,732
141190605,14,119,6,5,689,665,1354
141190606,14,119,6,6,697,722,1419
141190607,14,119,6,7,442,455,897
141190608,14,119,6,8,296,351,647
141190609,14,119,6,9,360,416,776
141190610,14,119,6,10,428,484,912
141190611,14,119,6,11,467,506,973
141190612,14,119,6,12,469,503,972
141190613,14,119,6,13,276,341,617
141190614,14,119,6,14,206,246,452
141190615,14,119,6,15,336,369,705
141190616,14,119,6,16,423,439,862
141190617,14,119,6,17,381,389,770
141190618,14,119,6,18,437,430,867
141190619,14,119,6,19,547,548,1095
141190620,14,119,6,20,536,547,1083
141190621,14,119,6,21,557,556,1113
141190701,14,119,7,1,560,581,1141
141190702,14,119,7,2,524,531,1055
141190703,14,119,7,3,739,804,1543
141190704,14,119,7,4,591,635,1226
141190705,14,119,7,5,532,597,1129
141190706,14,119,7,6,552,581,1133
141190707,14,119,7,7,404,477,881
141190708,14,119,7,8,569,588,1157
141190709,14,119,7,9,546,543,1089
141190710,14,119,7,10,470,545,1015
141190711,14,119,7,11,361,392,753
141190712,14,119,7,12,408,485,893
141190713,14,119,7,13,493,498,991
141190714,14,119,7,14,355,374,729
141190801,14,119,8,1,610,572,1182
141190802,14,119,8,2,408,386,794
141190803,14,119,8,3,304,322,626
141190804,14,119,8,4,320,359,679
141190805,14,119,8,5,348,390,738
141190806,14,119,8,6,384,356,740
141190807,14,119,8,7,404,425,829
141190808,14,119,8,8,540,612,1152
141190809,14,119,8,9,475,505,980
141190810,14,119,8,10,438,528,966
141190811,14,119,8,11,409,450,859
141190812,14,119,8,12,555,549,1104
141190813,14,119,8,13,447,438,885
141190814,14,119,8,14,428,468,896
141190815,14,119,8,15,594,685,1279
141190816,14,119,8,16,348,384,732
141190817,14,119,8,17,423,449,872
141190901,14,119,9,1,405,436,841
141190902,14,119,9,2,463,464,927
141190903,14,119,9,3,260,277,537
141190904,14,119,9,4,360,391,751
141190905,14,119,9,5,361,396,757
141190906,14,119,9,6,308,353,661
141190907,14,119,9,7,296,320,616
141190908,14,119,9,8,295,356,651
141190909,14,119,9,9,351,421,772
141190910,14,119,9,10,189,270,459
141190911,14,119,9,11,418,457,875
141190912,14,119,9,12,538,585,1123
141190913,14,119,9,13,215,260,475
141190914,14,119,9,14,441,510,951
141190915,14,119,9,15,333,377,710
141190916,14,119,9,16,534,522,1056
141190917,14,119,9,17,491,527,1018
141260101,14,126,1,1,68,65,133
141260102,14,126,1,2,79,73,152
141260103,14,126,1,3,98,69,167
141260104,14,126,1,4,93,86,179
141260105,14,126,1,5,20,19,39
141260106,14,126,1,6,60,43,103
141260107,14,126,1,7,67,50,117
141260108,14,126,1,8,89,105,194
141260109,14,126,1,9,189,197,386
141260201,14,126,2,1,84,82,166
141260202,14,126,2,2,14,12,26
141260203,14,126,2,3,64,50,114
141260204,14,126,2,4,122,117,239
141260205,14,126,2,5,41,34,75
141260206,14,126,2,6,438,370,808
141260207,14,126,2,7,62,51,113
141260208,14,126,2,8,322,336,658
141260301,14,126,3,1,31,25,56
141260302,14,126,3,2,3,2,5
141260303,14,126,3,3,223,237,460
141260304,14,126,3,4,552,522,1074
141260305,14,126,3,5,82,71,153
141260306,14,126,3,6,72,58,130
141260307,14,126,3,7,401,410,811
141260308,14,126,3,8,458,483,941
141260309,14,126,3,9,292,296,588
141260310,14,126,3,10,209,202,411
141260311,14,126,3,11,387,417,804
141260312,14,126,3,12,382,395,777
141260313,14,126,3,13,441,418,859
141260314,14,126,3,14,558,602,1160
141260401,14,126,4,1,161,140,301
141260402,14,126,4,2,64,53,117
141260403,14,126,4,3,54,51,105
141260404,14,126,4,4,205,180,385
141260405,14,126,4,5,66,71,137
141260406,14,126,4,6,285,260,545
141260501,14,126,5,1,20,15,35
141260502,14,126,5,2,194,162,356
141260503,14,126,5,3,8,5,13
141260504,14,126,5,4,207,228,435
141260505,14,126,5,5,189,174,363
141260506,14,126,5,6,121,142,263
141260507,14,126,5,7,231,240,471
141260508,14,126,5,8,425,487,912
141260509,14,126,5,9,665,665,1330
141260510,14,126,5,10,405,428,833
141260511,14,126,5,11,418,476,894
141260512,14,126,5,12,610,628,1238
141260513,14,126,5,13,305,298,603
141260514,14,126,5,14,439,393,832
141260515,14,126,5,15,210,221,431
141260516,14,126,5,16,413,440,853
141260517,14,126,5,17,307,335,642
141260518,14,126,5,18,253,230,483
141260601,14,126,6,1,118,95,213
141260602,14,126,6,2,59,29,88
141260603,14,126,6,3,197,221,418
141260604,14,126,6,4,197,198,395
141260605,14,126,6,5,237,229,466
141260606,14,126,6,6,48,42,90
141260607,14,126,6,7,244,206,450
141260608,14,126,6,8,289,333,622
141260609,14,126,6,9,285,291,576
141260610,14,126,6,10,303,288,591
141260611,14,126,6,11,67,66,133
141260701,14,126,7,1,235,284,519
141260702,14,126,7,2,357,393,750
141260703,14,126,7,3,229,283,512
141260704,14,126,7,4,376,386,762
141260705,14,126,7,5,360,408,768
141260706,14,126,7,6,270,363,633
141260707,14,126,7,7,312,342,654
141260708,14,126,7,8,432,444,876
141260709,14,126,7,9,298,322,620
141260710,14,126,7,10,257,258,515
141260711,14,126,7,11,353,379,732
141260712,14,126,7,12,419,445,864
141260713,14,126,7,13,141,141,282
141330101,14,133,1,1,39,34,73
141330102,14,133,1,2,181,178,359
141330103,14,133,1,3,251,257,508
141330104,14,133,1,4,228,212,440
141330105,14,133,1,5,491,523,1014
141330106,14,133,1,6,40,34,74
141330107,14,133,1,7,58,65,123
141330108,14,133,1,8,426,444,870
141330109,14,133,1,9,226,169,395
141330110,14,133,1,10,470,497,967
141330111,14,133,1,11,620,627,1247
141330112,14,133,1,12,511,525,1036
141330201,14,133,2,1,332,267,599
141330202,14,133,2,2,124,114,238
141330203,14,133,2,3,111,119,230
141330204,14,133,2,4,477,450,927
141330205,14,133,2,5,154,156,310
141330206,14,133,2,6,152,135,287
141330207,14,133,2,7,192,206,398
141330208,14,133,2,8,308,313,621
141330209,14,133,2,9,145,154,299
141330210,14,133,2,10,102,131,233
141330211,14,133,2,11,264,295,559
141330212,14,133,2,12,258,248,506
141330213,14,133,2,13,518,525,1043
141330214,14,133,2,14,368,394,762
141330215,14,133,2,15,87,97,184
141330216,14,133,2,16,321,315,636
141330301,14,133,3,1,155,139,294
141330302,14,133,3,2,207,205,412
141330303,14,133,3,3,121,131,252
141330304,14,133,3,4,285,208,493
141330305,14,133,3,5,227,204,431
141330306,14,133,3,6,207,160,367
141330307,14,133,3,7,572,638,1210
141330308,14,133,3,8,249,255,504
141330309,14,133,3,9,344,383,727
141330401,14,133,4,1,41,31,72
141330402,14,133,4,2,99,82,181
141330403,14,133,4,3,85,93,178
141330404,14,133,4,4,109,100,209
141330405,14,133,4,5,204,203,407
141330406,14,133,4,6,87,91,178
141330407,14,133,4,7,133,131,264
141330408,14,133,4,8,217,190,407
141330409,14,133,4,9,588,601,1189
141330410,14,133,4,10,206,212,418
141330411,14,133,4,11,269,266,535
141330501,14,133,5,1,518,592,1110
141330502,14,133,5,2,247,327,574
141330503,14,133,5,3,319,370,689
141330504,14,133,5,4,430,446,876
141330505,14,133,5,5,515,545,1060
141330506,14,133,5,6,485,576,1061
141330507,14,133,5,7,327,408,735
141330508,14,133,5,8,324,422,746
141330509,14,133,5,9,261,361,622
141330510,14,133,5,10,459,571,1030
141330511,14,133,5,11,438,495,933
141330512,14,133,5,12,865,642,1507
141330513,14,133,5,13,403,479,882
141330514,14,133,5,14,205,217,422
141330515,14,133,5,15,707,742,1449
141330516,14,133,5,16,391,457,848
141330517,14,133,5,17,408,427,835
141330601,14,133,6,1,360,446,806
141330602,14,133,6,2,571,626,1197
141330603,14,133,6,3,410,468,878
141330604,14,133,6,4,371,421,792
141330605,14,133,6,5,471,492,963
141330606,14,133,6,6,274,284,558
141330607,14,133,6,7,615,555,1170
141330608,14,133,6,8,393,387,780
141330609,14,133,6,9,294,392,686
141330610,14,133,6,10,344,453,797
141330611,14,133,6,11,309,356,665
141330612,14,133,6,12,269,294,563
141330613,14,133,6,13,551,652,1203
141330614,14,133,6,14,573,601,1174
141330615,14,133,6,15,364,434,798
141330616,14,133,6,16,372,424,796
141330617,14,133,6,17,304,345,649
141400101,14,140,1,1,104,74,178
141400102,14,140,1,2,80,79,159
141400103,14,140,1,3,211,178,389
141400104,14,140,1,4,66,52,118
141400105,14,140,1,5,50,41,91
141400106,14,140,1,6,36,33,69
141400107,14,140,1,7,52,39,91
141400108,14,140,1,8,101,62,163
141400109,14,140,1,9,398,408,806
141400110,14,140,1,10,274,298,572
141400111,14,140,1,11,386,368,754
141400112,14,140,1,12,370,384,754
141400113,14,140,1,13,104,123,227
141400201,14,140,2,1,90,56,146
141400202,14,140,2,2,168,145,313
141400203,14,140,2,3,120,98,218
141400204,14,140,2,4,176,155,331
141400205,14,140,2,5,68,61,129
141400206,14,140,2,6,180,144,324
141400207,14,140,2,7,56,40,96
141400208,14,140,2,8,134,99,233
141400209,14,140,2,9,123,70,193
141400210,14,140,2,10,60,47,107
141400211,14,140,2,11,237,275,512
141400212,14,140,2,12,372,373,745
141400213,14,140,2,13,145,152,297
141400301,14,140,3,1,711,645,1356
141400302,14,140,3,2,640,667,1307
141400303,14,140,3,3,302,310,612
141400304,14,140,3,4,347,355,702
141400305,14,140,3,5,521,516,1037
141400306,14,140,3,6,399,413,812
141400307,14,140,3,7,457,456,913
141400308,14,140,3,8,532,573,1105
141400309,14,140,3,9,343,343,686
141400310,14,140,3,10,363,411,774
141400311,14,140,3,11,293,369,662
141400312,14,140,3,12,400,422,822
141400313,14,140,3,13,166,213,379
141400401,14,140,4,1,279,327,606
141400402,14,140,4,2,324,351,675
141400403,14,140,4,3,258,259,517
141400404,14,140,4,4,231,301,532
141400405,14,140,4,5,270,326,596
141400406,14,140,4,6,320,386,706
141400407,14,140,4,7,475,544,1019
141400408,14,140,4,8,618,654,1272
141400409,14,140,4,9,599,628,1227
141400410,14,140,4,10,393,389,782
141400411,14,140,4,11,317,301,618
141400412,14,140,4,12,530,522,1052
141400413,14,140,4,13,687,691,1378
141400501,14,140,5,1,111,109,220
141400502,14,140,5,2,171,144,315
141400503,14,140,5,3,65,53,118
141400504,14,140,5,4,102,54,156
141400505,14,140,5,5,145,109,254
141400506,14,140,5,6,123,85,208
141400507,14,140,5,7,28,13,41
141400508,14,140,5,8,387,466,853
141400509,14,140,5,9,390,464,854
141400510,14,140,5,10,151,165,316
141400511,14,140,5,11,534,549,1083
141400512,14,140,5,12,341,370,711
141400513,14,140,5,13,281,298,579
141400514,14,140,5,14,375,445,820
141400515,14,140,5,15,414,449,863
141400516,14,140,5,16,421,411,832
141400517,14,140,5,17,289,336,625
141400518,14,140,5,18,285,307,592
141400519,14,140,5,19,284,320,604
141400520,14,140,5,20,587,600,1187
141400601,14,140,6,1,25,20,45
141400602,14,140,6,2,60,46,106
141400603,14,140,6,3,37,25,62
141400604,14,140,6,4,180,139,319
141400605,14,140,6,5,143,131,274
141400606,14,140,6,6,84,83,167
141400607,14,140,6,7,83,85,168
141400608,14,140,6,8,90,67,157
141400609,14,140,6,9,61,52,113
141400610,14,140,6,10,577,625,1202
141400611,14,140,6,11,323,378,701
141400612,14,140,6,12,322,338,660
141400613,14,140,6,13,223,220,443
141400614,14,140,6,14,367,378,745
141400615,14,140,6,15,279,287,566
141400616,14,140,6,16,586,614,1200
141400617,14,140,6,17,238,266,504
141400618,14,140,6,18,200,242,442
141400619,14,140,6,19,481,527,1008
141400701,14,140,7,1,413,386,799
141400702,14,140,7,2,406,480,886
141400703,14,140,7,3,322,338,660
141400704,14,140,7,4,261,265,526
141400705,14,140,7,5,666,681,1347
141400706,14,140,7,6,609,636,1245
141400707,14,140,7,7,221,261,482
141400708,14,140,7,8,183,222,405
141400709,14,140,7,9,360,400,760
141400710,14,140,7,10,691,684,1375
141400711,14,140,7,11,463,446,909
141400712,14,140,7,12,237,279,516
141400713,14,140,7,13,500,507,1007
141400714,14,140,7,14,508,535,1043
141400715,14,140,7,15,414,441,855
141400716,14,140,7,16,348,423,771
141400717,14,140,7,17,194,198,392
141400718,14,140,7,18,444,514,958
141400719,14,140,7,19,448,484,932
141400720,14,140,7,20,503,519,1022
141400801,14,140,8,1,368,298,666
141400802,14,140,8,2,231,191,422
141400803,14,140,8,3,341,297,638
141400804,14,140,8,4,407,331,738
141400805,14,140,8,5,183,151,334
141400806,14,140,8,6,76,69,145
141400807,14,140,8,7,189,157,346
141400808,14,140,8,8,171,137,308
141400809,14,140,8,9,474,473,947
141400810,14,140,8,10,574,590,1164
141400811,14,140,8,11,374,360,734
141400812,14,140,8,12,528,576,1104
141400813,14,140,8,13,372,416,788
141400814,14,140,8,14,399,424,823
141400815,14,140,8,15,356,407,763
141400816,14,140,8,16,284,337,621
141400817,14,140,8,17,388,467,855
141400818,14,140,8,18,540,551,1091
141400819,14,140,8,19,436,479,915
141400820,14,140,8,20,516,516,1032
141400821,14,140,8,21,454,268,722
141400901,14,140,9,1,147,122,269
141400902,14,140,9,2,67,54,121
141400903,14,140,9,3,153,127,280
141400904,14,140,9,4,272,240,512
141400905,14,140,9,5,126,99,225
141400906,14,140,9,6,194,169,363
141400907,14,140,9,7,82,58,140
141400908,14,140,9,8,408,437,845
141400909,14,140,9,9,427,446,873
141400910,14,140,9,10,464,477,941
141400911,14,140,9,11,526,521,1047
141400912,14,140,9,12,268,293,561
141400913,14,140,9,13,340,390,730
141400914,14,140,9,14,522,501,1023
141400915,14,140,9,15,470,565,1035
141400916,14,140,9,16,282,300,582
141401001,14,140,10,1,171,128,299
141401002,14,140,10,2,164,123,287
141401003,14,140,10,3,176,133,309
141401004,14,140,10,4,94,73,167
141401005,14,140,10,5,88,74,162
141401006,14,140,10,6,245,188,433
141401007,14,140,10,7,258,219,477
141401008,14,140,10,8,255,259,514
141401009,14,140,10,9,302,337,639
141401010,14,140,10,10,413,432,845
141401011,14,140,10,11,424,460,884
141401012,14,140,10,12,485,557,1042
141401013,14,140,10,13,189,219,408
141401014,14,140,10,14,298,327,625
141401015,14,140,10,15,388,418,806
141401016,14,140,10,16,448,525,973
141401017,14,140,10,17,507,530,1037
141401101,14,140,11,1,240,213,453
141401102,14,140,11,2,358,326,684
141401103,14,140,11,3,499,520,1019
141401104,14,140,11,4,261,325,586
141401105,14,140,11,5,368,408,776
141401106,14,140,11,6,260,280,540
141401107,14,140,11,7,253,279,532
141401108,14,140,11,8,740,788,1528
141401109,14,140,11,9,400,398,798
141401110,14,140,11,10,394,439,833
141401111,14,140,11,11,279,337,616
141401112,14,140,11,12,220,299,519
141401113,14,140,11,13,359,386,745
141401114,14,140,11,14,311,389,700
141401115,14,140,11,15,235,273,508
141401116,14,140,11,16,217,270,487
141401117,14,140,11,17,214,269,483
141401118,14,140,11,18,341,422,763
141401119,14,140,11,19,368,417,785
141401120,14,140,11,20,461,512,973
141401121,14,140,11,21,470,493,963
141401201,14,140,12,1,325,334,659
141401202,14,140,12,2,246,258,504
141401203,14,140,12,3,493,458,951
141401204,14,140,12,4,392,371,763
141401205,14,140,12,5,643,664,1307
141401206,14,140,12,6,728,728,1456
141401207,14,140,12,7,407,427,834
141401208,14,140,12,8,381,399,780
141401209,14,140,12,9,337,364,701
141401210,14,140,12,10,576,584,1160
141401211,14,140,12,11,628,625,1253
141401212,14,140,12,12,480,550,1030
141401213,14,140,12,13,348,401,749
141401214,14,140,12,14,261,295,556
141401215,14,140,12,15,260,307,567
141401216,14,140,12,16,255,331,586
141401217,14,140,12,17,246,343,589
141401218,14,140,12,18,216,281,497
141401219,14,140,12,19,363,345,708
141401301,14,140,13,1,316,383,699
141401302,14,140,13,2,274,286,560
141401303,14,140,13,3,249,272,521
141401304,14,140,13,4,339,354,693
141401305,14,140,13,5,353,418,771
141401306,14,140,13,6,305,345,650
141401307,14,140,13,7,271,273,544
141401308,14,140,13,8,227,262,489
141401309,14,140,13,9,286,305,591
141401310,14,140,13,10,284,329,613
141401311,14,140,13,11,271,331,602
141401312,14,140,13,12,305,313,618
141401313,14,140,13,13,375,392,767
141401314,14,140,13,14,257,294,551
141401315,14,140,13,15,629,601,1230
141401316,14,140,13,16,395,437,832
141401317,14,140,13,17,636,635,1271
141401318,14,140,13,18,388,406,794
141401401,14,140,14,1,805,541,1346
141401402,14,140,14,2,410,384,794
141401403,14,140,14,3,359,334,693
141401404,14,140,14,4,291,342,633
141401405,14,140,14,5,330,395,725
141401406,14,140,14,6,237,253,490
141401407,14,140,14,7,243,282,525
141401408,14,140,14,8,212,252,464
141401409,14,140,14,9,213,245,458
141401410,14,140,14,10,220,259,479
141401411,14,140,14,11,309,323,632
141401412,14,140,14,12,463,494,957
141401413,14,140,14,13,569,607,1176
141401414,14,140,14,14,629,725,1354
141401415,14,140,14,15,458,495,953
141401416,14,140,14,16,437,477,914
141401417,14,140,14,17,330,384,714
141401418,14,140,14,18,392,484,876
141401419,14,140,14,19,529,509,1038
141401420,14,140,14,20,291,320,611
141401421,14,140,14,21,346,343,689
141401422,14,140,14,22,299,326,625
141401423,14,140,14,23,435,432,867
141401501,14,140,15,1,145,116,261
141401502,14,140,15,2,115,80,195
141401503,14,140,15,3,118,108,226
141401504,14,140,15,4,196,153,349
141401505,14,140,15,5,180,139,319
141401506,14,140,15,6,93,79,172
141401507,14,140,15,7,363,387,750
141401508,14,140,15,8,287,276,563
141401509,14,140,15,9,325,356,681
141401510,14,140,15,10,435,478,913
141401511,14,140,15,11,369,423,792
141401512,14,140,15,12,467,468,935
141401513,14,140,15,13,701,722,1423
141401514,14,140,15,14,190,174,364
141401515,14,140,15,15,156,158,314
141401601,14,140,16,1,82,54,136
141401602,14,140,16,2,114,96,210
141401603,14,140,16,3,100,72,172
141401604,14,140,16,4,19,18,37
141401605,14,140,16,5,176,151,327
141401606,14,140,16,6,171,136,307
141401607,14,140,16,7,292,328,620
141401608,14,140,16,8,544,582,1126
141401609,14,140,16,9,377,373,750
141401610,14,140,16,10,573,564,1137
141401611,14,140,16,11,458,488,946
141401612,14,140,16,12,319,358,677
141401613,14,140,16,13,264,281,545
141401614,14,140,16,14,475,486,961
141401615,14,140,16,15,345,342,687
141401701,14,140,17,1,123,94,217
141401702,14,140,17,2,153,126,279
141401703,14,140,17,3,72,60,132
141401704,14,140,17,4,47,34,81
141401705,14,140,17,5,175,138,313
141401706,14,140,17,6,98,86,184
141401707,14,140,17,7,42,30,72
141401708,14,140,17,8,178,110,288
141401709,14,140,17,9,181,181,362
141401710,14,140,17,10,144,103,247
141401711,14,140,17,11,638,653,1291
141401712,14,140,17,12,285,313,598
141401713,14,140,17,13,208,238,446
141401714,14,140,17,14,475,549,1024
141401715,14,140,17,15,538,511,1049
141401716,14,140,17,16,323,323,646
141401717,14,140,17,17,417,392,809
141401718,14,140,17,18,155,136,291
141401719,14,140,17,19,400,385,785
141401720,14,140,17,20,261,274,535
141401801,14,140,18,1,311,334,645
141401802,14,140,18,2,442,417,859
141401803,14,140,18,3,325,345,670
141401804,14,140,18,4,346,376,722
141401805,14,140,18,5,391,384,775
141401806,14,140,18,6,455,483,938
141401807,14,140,18,7,281,317,598
141401808,14,140,18,8,378,436,814
141401809,14,140,18,9,323,398,721
141401810,14,140,18,10,225,272,497
141401811,14,140,18,11,322,366,688
141401812,14,140,18,12,352,357,709
141401901,14,140,19,1,561,568,1129
141401902,14,140,19,2,261,334,595
141401903,14,140,19,3,183,222,405
141401904,14,140,19,4,217,255,472
141401905,14,140,19,5,236,245,481
141401906,14,140,19,6,268,329,597
141401907,14,140,19,7,273,320,593
141401908,14,140,19,8,269,283,552
141401909,14,140,19,9,441,435,876
141401910,14,140,19,10,599,636,1235
141401911,14,140,19,11,319,348,667
141470101,14,147,1,1,48,43,91
141470102,14,147,1,2,354,322,676
141470103,14,147,1,3,315,305,620
141470104,14,147,1,4,571,564,1135
141470105,14,147,1,5,590,652,1242
141470106,14,147,1,6,438,457,895
141470107,14,147,1,7,582,621,1203
141470108,14,147,1,8,346,337,683
141470109,14,147,1,9,800,797,1597
141470110,14,147,1,10,607,677,1284
141470111,14,147,1,11,496,520,1016
141470112,14,147,1,12,339,403,742
141470113,14,147,1,13,357,392,749
141470114,14,147,1,14,547,518,1065
141470201,14,147,2,1,286,270,556
141470202,14,147,2,2,916,906,1822
141470203,14,147,2,3,2483,307,2790
141470204,14,147,2,4,417,353,770
141470205,14,147,2,5,729,556,1285
141470206,14,147,2,6,96,82,178
141470207,14,147,2,7,586,564,1150
141470208,14,147,2,8,480,462,942
141470209,14,147,2,9,407,434,841
141470210,14,147,2,10,712,713,1425
141470211,14,147,2,11,384,407,791
141470212,14,147,2,12,367,372,739
141470213,14,147,2,13,429,459,888
141470301,14,147,3,1,77,43,120
141470302,14,147,3,2,203,168,371
141470303,14,147,3,3,227,182,409
141470304,14,147,3,4,211,223,434
141470305,14,147,3,5,139,119,258
141470306,14,147,3,6,37,30,67
141470307,14,147,3,7,250,244,494
141470308,14,147,3,8,676,648,1324
141470309,14,147,3,9,418,447,865
141470310,14,147,3,10,486,481,967
141470311,14,147,3,11,330,315,645
141470312,14,147,3,12,287,272,559
141470313,14,147,3,13,198,218,416
141470314,14,147,3,14,191,198,389
141470401,14,147,4,1,102,93,195
141470402,14,147,4,2,59,54,113
141470403,14,147,4,3,122,93,215
141470404,14,147,4,4,19,13,32
141470405,14,147,4,5,262,293,555
141470406,14,147,4,6,232,249,481
141470407,14,147,4,7,463,536,999
141470408,14,147,4,8,479,533,1012
141470409,14,147,4,9,253,278,531
141470410,14,147,4,10,380,412,792
141470411,14,147,4,11,324,394,718
141470412,14,147,4,12,594,631,1225
141470413,14,147,4,13,273,245,518
141470501,14,147,5,1,52,39,91
141470502,14,147,5,2,47,34,81
141470503,14,147,5,3,66,57,123
141470504,14,147,5,4,99,50,149
141470505,14,147,5,5,36,24,60
141470506,14,147,5,6,23,17,40
141470507,14,147,5,7,160,177,337
141470508,14,147,5,8,344,332,676
141470601,14,147,6,1,237,212,449
141470602,14,147,6,2,247,190,437
141470603,14,147,6,3,218,212,430
141470604,14,147,6,4,178,184,362
141470605,14,147,6,5,135,135,270
141470606,14,147,6,6,242,272,514
141470607,14,147,6,7,163,200,363
141470608,14,147,6,8,247,240,487
141470609,14,147,6,9,209,210,419
141470610,14,147,6,10,227,256,483
141470701,14,147,7,1,57,39,96
141470702,14,147,7,2,39,15,54
141470703,14,147,7,3,24,21,45
141470704,14,147,7,4,104,55,159
141470705,14,147,7,5,5,4,9
141470706,14,147,7,6,53,45,98
141470707,14,147,7,7,56,51,107
141470708,14,147,7,8,87,47,134
141470709,14,147,7,9,90,98,188
141470710,14,147,7,10,164,158,322
141470711,14,147,7,11,160,144,304
141470712,14,147,7,12,108,95,203
141470713,14,147,7,13,84,63,147
141470714,14,147,7,14,273,259,532
141470801,14,147,8,1,447,474,921
141470802,14,147,8,2,583,622,1205
141470803,14,147,8,3,688,659,1347
141470804,14,147,8,4,444,477,921
141470805,14,147,8,5,824,933,1757
141470806,14,147,8,6,667,718,1385
141470807,14,147,8,7,507,542,1049
141470808,14,147,8,8,400,470,870
141470809,14,147,8,9,317,368,685
141470810,14,147,8,10,230,276,506
141470811,14,147,8,11,329,355,684
141470812,14,147,8,12,597,606,1203
141470813,14,147,8,13,303,387,690
141470814,14,147,8,14,325,384,709
141470815,14,147,8,15,297,363,660
141470816,14,147,8,16,206,275,481
141470817,14,147,8,17,133,156,289
141470901,14,147,9,1,615,601,1216
141470902,14,147,9,2,810,828,1638
141470903,14,147,9,3,708,768,1476
141470904,14,147,9,4,361,372,733
141470905,14,147,9,5,365,399,764
141470906,14,147,9,6,527,582,1109
141470907,14,147,9,7,232,281,513
141470908,14,147,9,8,467,503,970
141470909,14,147,9,9,269,321,590
141470910,14,147,9,10,293,355,648
141470911,14,147,9,11,303,327,630
141470912,14,147,9,12,585,653,1238
141470913,14,147,9,13,581,655,1236
141470914,14,147,9,14,324,373,697
141470915,14,147,9,15,335,460,795
141470916,14,147,9,16,353,390,743
141470917,14,147,9,17,316,334,650
141470918,14,147,9,18,389,414,803
141470919,14,147,9,19,478,511,989
141471001,14,147,10,1,325,331,656
141471002,14,147,10,2,432,463,895
141471003,14,147,10,3,229,349,578
141471004,14,147,10,4,296,344,640
141471005,14,147,10,5,399,482,881
141471006,14,147,10,6,289,311,600
141471007,14,147,10,7,317,409,726
141471008,14,147,10,8,577,631,1208
141471009,14,147,10,9,391,404,795
141471010,14,147,10,10,588,678,1266
141471011,14,147,10,11,788,786,1574
141471012,14,147,10,12,514,545,1059
141471013,14,147,10,13,528,520,1048
141471014,14,147,10,14,820,772,1592
141471015,14,147,10,15,921,901,1822
141540101,14,154,1,1,55,36,91
141540102,14,154,1,2,81,64,145
141540103,14,154,1,3,181,156,337
141540104,14,154,1,4,178,175,353
141540105,14,154,1,5,43,16,59
141540106,14,154,1,6,13,6,19
141540107,14,154,1,7,60,50,110
141540201,14,154,2,1,95,81,176
141540202,14,154,2,2,14,7,21
141540203,14,154,2,3,44,46,90
141540204,14,154,2,4,176,107,283
141540205,14,154,2,5,50,28,78
141540206,14,154,2,6,38,38,76
141540207,14,154,2,7,56,43,99
141540208,14,154,2,8,61,55,116
141540209,14,154,2,9,267,302,569
141540210,14,154,2,10,363,381,744
141540211,14,154,2,11,466,477,943
141540212,14,154,2,12,137,145,282
141610101,14,161,1,1,41,41,82
141610102,14,161,1,2,58,67,125
141610103,14,161,1,3,86,68,154
141610104,14,161,1,4,136,102,238
141610105,14,161,1,5,134,102,236
141610106,14,161,1,6,43,37,80
141610107,14,161,1,7,59,43,102
141610108,14,161,1,8,61,47,108
141610109,14,161,1,9,67,64,131
141610110,14,161,1,10,106,84,190
141610111,14,161,1,11,62,39,101
141610112,14,161,1,12,437,429,866
141610113,14,161,1,13,412,449,861
141610114,14,161,1,14,245,250,495
141610115,14,161,1,15,284,275,559
141610116,14,161,1,16,348,407,755
141610117,14,161,1,17,469,477,946
141610201,14,161,2,1,71,63,134
141610202,14,161,2,2,70,54,124
141610203,14,161,2,3,33,24,57
141610204,14,161,2,4,38,34,72
141610205,14,161,2,5,30,22,52
141610206,14,161,2,6,56,47,103
141610207,14,161,2,7,342,338,680
141610208,14,161,2,8,331,384,715
141610209,14,161,2,9,353,392,745
141610210,14,161,2,10,266,322,588
141610211,14,161,2,11,290,341,631
141610212,14,161,2,12,299,284,583
141610213,14,161,2,13,323,346,669
141610214,14,161,2,14,353,334,687
141610215,14,161,2,15,280,277,557
141610216,14,161,2,16,327,324,651
141610301,14,161,3,1,158,121,279
141610302,14,161,3,2,569,330,899
141610303,14,161,3,3,81,65,146
141610304,14,161,3,4,179,143,322
141610305,14,161,3,5,235,215,450
141610306,14,161,3,6,426,456,882
141610307,14,161,3,7,514,527,1041
141610308,14,161,3,8,268,315,583
141610309,14,161,3,9,326,325,651
141610310,14,161,3,10,448,494,942
141610311,14,161,3,11,269,289,558
141610312,14,161,3,12,218,235,453
141610313,14,161,3,13,241,267,508
141610401,14,161,4,1,91,82,173
141610402,14,161,4,2,68,65,133
141610403,14,161,4,3,47,30,77
141610404,14,161,4,4,67,53,120
141610405,14,161,4,5,139,110,249
141610406,14,161,4,6,91,78,169
141610407,14,161,4,7,138,109,247
141610408,14,161,4,8,31,21,52
141610409,14,161,4,9,90,76,166
141610410,14,161,4,10,116,88,204
141610411,14,161,4,11,149,164,313
141610412,14,161,4,12,404,371,775
141610413,14,161,4,13,349,373,722
141610501,14,161,5,1,38,37,75
141610502,14,161,5,2,41,36,77
141610503,14,161,5,3,156,129,285
141610504,14,161,5,4,41,40,81
141610505,14,161,5,5,79,58,137
141610506,14,161,5,6,420,370,790
141610507,14,161,5,7,562,521,1083
141610508,14,161,5,8,277,296,573
141610509,14,161,5,9,363,392,755
141610510,14,161,5,10,258,275,533
141610511,14,161,5,11,348,359,707
141610512,14,161,5,12,324,319,643
141610601,14,161,6,1,393,386,779
141610602,14,161,6,2,474,505,979
141610603,14,161,6,3,550,597,1147
141610604,14,161,6,4,464,467,931
141610605,14,161,6,5,314,315,629
141610606,14,161,6,6,482,513,995
141610607,14,161,6,7,441,498,939
141610608,14,161,6,8,276,310,586
141610609,14,161,6,9,305,339,644
141610610,14,161,6,10,385,387,772
141610611,14,161,6,11,319,370,689
141610612,14,161,6,12,305,380,685
141610613,14,161,6,13,457,430,887
141610614,14,161,6,14,391,369,760
141610701,14,161,7,1,327,365,692
141610702,14,161,7,2,261,279,540
141610703,14,161,7,3,389,470,859
141610704,14,161,7,4,198,244,442
141610705,14,161,7,5,208,245,453
141610706,14,161,7,6,371,429,800
141610707,14,161,7,7,321,345,666
141610708,14,161,7,8,433,458,891
141610709,14,161,7,9,406,460,866
141610710,14,161,7,10,325,374,699
141610711,14,161,7,11,269,294,563
141610712,14,161,7,12,535,560,1095
141610713,14,161,7,13,432,510,942
141610714,14,161,7,14,390,470,860
141610715,14,161,7,15,617,687,1304
141610801,14,161,8,1,324,392,716
141610802,14,161,8,2,200,206,406
141610803,14,161,8,3,243,293,536
141610804,14,161,8,4,226,266,492
141610805,14,161,8,5,184,202,386
141610806,14,161,8,6,266,259,525
141610807,14,161,8,7,419,424,843
141610808,14,161,8,8,294,339,633
141610809,14,161,8,9,244,257,501
141610810,14,161,8,10,346,414,760
141610811,14,161,8,11,216,254,470
141610812,14,161,8,12,222,264,486
141610813,14,161,8,13,211,268,479
141610814,14,161,8,14,291,364,655
141610815,14,161,8,15,361,336,697
141610816,14,161,8,16,279,294,573
141610817,14,161,8,17,473,478,951
141610901,14,161,9,1,413,395,808
141610902,14,161,9,2,555,564,1119
141610903,14,161,9,3,440,448,888
141610904,14,161,9,4,413,399,812
141610905,14,161,9,5,418,384,802
141610906,14,161,9,6,547,566,1113
141610907,14,161,9,7,387,418,805
141610908,14,161,9,8,323,368,691
141610909,14,161,9,9,311,346,657
141610910,14,161,9,10,270,335,605
141610911,14,161,9,11,333,436,769
141610912,14,161,9,12,386,382,768
141610913,14,161,9,13,340,429,769
141610914,14,161,9,14,257,304,561
141610915,14,161,9,15,376,446,822
141610916,14,161,9,16,242,282,524
141610917,14,161,9,17,295,321,616
141610918,14,161,9,18,375,450,825
141610919,14,161,9,19,322,338,660
141610920,14,161,9,20,263,315,578
141610921,14,161,9,21,497,540,1037
141610922,14,161,9,22,507,541,1048
141610923,14,161,9,23,320,341,661
141611001,14,161,10,1,244,322,566
141611002,14,161,10,2,346,411,757
141611003,14,161,10,3,267,363,630
141611004,14,161,10,4,253,323,576
141611005,14,161,10,5,250,306,556
141611006,14,161,10,6,328,401,729
141611007,14,161,10,7,464,499,963
141611008,14,161,10,8,351,383,734
141611009,14,161,10,9,249,303,552
141611010,14,161,10,10,195,251,446
141611011,14,161,10,11,240,276,516
141611012,14,161,10,12,403,450,853
141611013,14,161,10,13,255,315,570
141611014,14,161,10,14,242,326,568
141611015,14,161,10,15,247,276,523
141611016,14,161,10,16,322,389,711
141611017,14,161,10,17,448,517,965
141611018,14,161,10,18,462,498,960
141611019,14,161,10,19,529,546,1075
141611020,14,161,10,20,374,376,750
141611021,14,161,10,21,418,405,823
141611101,14,161,11,1,636,632,1268
141611102,14,161,11,2,380,405,785
141611103,14,161,11,3,302,281,583
141611104,14,161,11,4,448,477,925
141611105,14,161,11,5,328,356,684
141611106,14,161,11,6,354,372,726
141611107,14,161,11,7,277,322,599
141611108,14,161,11,8,233,275,508
141611109,14,161,11,9,232,277,509
141611110,14,161,11,10,433,411,844
141611111,14,161,11,11,620,609,1229
141611112,14,161,11,12,442,469,911
141611113,14,161,11,13,323,372,695
141611114,14,161,11,14,373,388,761
141611115,14,161,11,15,378,371,749
141611116,14,161,11,16,575,552,1127
141611117,14,161,11,17,371,386,757
141680101,14,168,1,1,85,68,153
141680102,14,168,1,2,78,63,141
141680103,14,168,1,3,47,46,93
141680104,14,168,1,4,19,17,36
141680105,14,168,1,5,40,21,61
141680106,14,168,1,6,72,50,122
141680107,14,168,1,7,69,43,112
141680108,14,168,1,8,146,122,268
141680109,14,168,1,9,41,44,85
141680110,14,168,1,10,181,159,340
141680111,14,168,1,11,370,384,754
141680112,14,168,1,12,394,442,836
141680113,14,168,1,13,284,266,550
141680114,14,168,1,14,587,567,1154
141680201,14,168,2,1,106,66,172
141680202,14,168,2,2,141,150,291
141680203,14,168,2,3,59,43,102
141680204,14,168,2,4,267,254,521
141680205,14,168,2,5,233,285,518
141680206,14,168,2,6,264,295,559
141680207,14,168,2,7,440,473,913
141680208,14,168,2,8,460,488,948
141680209,14,168,2,9,390,419,809
141680210,14,168,2,10,322,349,671
141680211,14,168,2,11,439,462,901
141680212,14,168,2,12,474,453,927
141680213,14,168,2,13,363,371,734
141680214,14,168,2,14,342,368,710
141680301,14,168,3,1,41,37,78
141680302,14,168,3,2,101,100,201
141680303,14,168,3,3,160,139,299
141680304,14,168,3,4,92,67,159
141680305,14,168,3,5,117,112,229
141680306,14,168,3,6,44,36,80
141680307,14,168,3,7,94,81,175
141680308,14,168,3,8,33,29,62
141680309,14,168,3,9,78,76,154
141680310,14,168,3,10,91,68,159
141680311,14,168,3,11,650,638,1288
141680312,14,168,3,12,443,431,874
141680313,14,168,3,13,662,655,1317
141750101,14,175,1,1,68,49,117
141750102,14,175,1,2,45,29,74
141750103,14,175,1,3,84,79,163
141750104,14,175,1,4,42,29,71
141750105,14,175,1,5,83,65,148
141750106,14,175,1,6,47,39,86
141750107,14,175,1,7,112,89,201
141750108,14,175,1,8,67,49,116
141750109,14,175,1,9,81,54,135
141750110,14,175,1,10,392,390,782
141750111,14,175,1,11,343,319,662
141750112,14,175,1,12,164,153,317
141750113,14,175,1,13,328,367,695
141750114,14,175,1,14,380,399,779
141750201,14,175,2,1,231,194,425
141750202,14,175,2,2,246,211,457
141750203,14,175,2,3,98,68,166
141750204,14,175,2,4,117,85,202
141750205,14,175,2,5,62,47,109
141750206,14,175,2,6,114,93,207
141750207,14,175,2,7,69,52,121
141750208,14,175,2,8,128,91,219
141750209,14,175,2,9,247,202,449
141750210,14,175,2,10,116,86,202
141750211,14,175,2,11,104,89,193
141750212,14,175,2,12,398,395,793
141750213,14,175,2,13,393,453,846
141750214,14,175,2,14,388,422,810
141750215,14,175,2,15,386,392,778
141750216,14,175,2,16,281,276,557
141750217,14,175,2,17,335,353,688
141750218,14,175,2,18,546,558,1104
141750219,14,175,2,19,1,0,1
141820101,14,182,1,1,105,80,185
141820102,14,182,1,2,119,90,209
141820103,14,182,1,3,86,69,155
141820104,14,182,1,4,99,70,169
141820105,14,182,1,5,123,103,226
141820106,14,182,1,6,196,153,349
141820107,14,182,1,7,126,100,226
141820108,14,182,1,8,153,104,257
141820109,14,182,1,9,87,66,153
141820110,14,182,1,10,173,132,305
141820111,14,182,1,11,267,260,527
141820112,14,182,1,12,376,365,741
141820113,14,182,1,13,356,389,745
141820114,14,182,1,14,225,212,437
141820115,14,182,1,15,293,283,576
141820116,14,182,1,16,507,496,1003
141820117,14,182,1,17,365,336,701
141820118,14,182,1,18,354,369,723
141820119,14,182,1,19,349,418,767
141820120,14,182,1,20,447,479,926
141820121,14,182,1,21,276,313,589
141820201,14,182,2,1,136,103,239
141820202,14,182,2,2,225,193,418
141820203,14,182,2,3,191,141,332
141820204,14,182,2,4,62,52,114
141820205,14,182,2,5,57,47,104
141820206,14,182,2,6,417,399,816
141820207,14,182,2,7,387,426,813
141820208,14,182,2,8,298,282,580
141820209,14,182,2,9,430,430,860
141820210,14,182,2,10,385,433,818
141820211,14,182,2,11,441,416,857
141820212,14,182,2,12,282,250,532
141820213,14,182,2,13,530,513,1043
141820214,14,182,2,14,241,229,470
141820301,14,182,3,1,110,86,196
141820302,14,182,3,2,38,34,72
141820303,14,182,3,3,388,214,602
141820304,14,182,3,4,89,51,140
141820305,14,182,3,5,64,46,110
141820306,14,182,3,6,115,93,208
141820307,14,182,3,7,466,475,941
141820308,14,182,3,8,364,353,717
141820309,14,182,3,9,216,245,461
141820310,14,182,3,10,591,635,1226
141820401,14,182,4,1,69,58,127
141820402,14,182,4,2,207,175,382
141820403,14,182,4,3,132,137,269
141820404,14,182,4,4,57,45,102
141820405,14,182,4,5,59,46,105
141820406,14,182,4,6,107,85,192
141820407,14,182,4,7,73,57,130
141820408,14,182,4,8,209,175,384
141820409,14,182,4,9,358,356,714
141820410,14,182,4,10,343,362,705
141820411,14,182,4,11,465,463,928
141820412,14,182,4,12,366,380,746
141820413,14,182,4,13,504,496,1000
141820414,14,182,4,14,338,350,688
141820415,14,182,4,15,456,465,921
141820501,14,182,5,1,59,33,92
141820502,14,182,5,2,46,39,85
141820503,14,182,5,3,11,9,20
141820504,14,182,5,4,38,28,66
141820505,14,182,5,5,125,102,227
141820506,14,182,5,6,36,30,66
141820507,14,182,5,7,27,28,55
141820508,14,182,5,8,51,41,92
141820509,14,182,5,9,312,320,632
141820510,14,182,5,10,242,231,473
141820511,14,182,5,11,442,467,909
141820512,14,182,5,12,384,365,749
141820513,14,182,5,13,364,362,726
141820514,14,182,5,14,272,295,567
141820515,14,182,5,15,346,352,698
141820516,14,182,5,16,384,406,790
141820517,14,182,5,17,228,268,496
141820518,14,182,5,18,469,513,982
141820519,14,182,5,19,190,217,407
141820520,14,182,5,20,299,304,603
141820521,14,182,5,21,333,341,674
141820601,14,182,6,1,44,31,75
141820602,14,182,6,2,79,59,138
141820603,14,182,6,3,43,30,73
141820604,14,182,6,4,78,76,154
141820605,14,182,6,5,66,49,115
141820606,14,182,6,6,8,11,19
141820607,14,182,6,7,448,498,946
141820608,14,182,6,8,269,289,558
141820609,14,182,6,9,727,795,1522
141820610,14,182,6,10,381,392,773
141820611,14,182,6,11,258,282,540
141820612,14,182,6,12,511,514,1025
141820613,14,182,6,13,298,337,635
141820614,14,182,6,14,172,199,371
141820615,14,182,6,15,390,436,826
141820616,14,182,6,16,338,354,692
141820617,14,182,6,17,279,299,578
141820618,14,182,6,18,186,177,363
141820619,14,182,6,19,182,191,373
141820701,14,182,7,1,47,25,72
141820702,14,182,7,2,119,109,228
141820703,14,182,7,3,87,59,146
141820704,14,182,7,4,44,25,69
141820705,14,182,7,5,75,67,142
141820706,14,182,7,6,68,35,103
141820707,14,182,7,7,222,200,422
141820708,14,182,7,8,102,70,172
141820709,14,182,7,9,77,58,135
141820710,14,182,7,10,64,43,107
141820711,14,182,7,11,364,335,699
141820712,14,182,7,12,190,197,387
141820713,14,182,7,13,260,266,526
141820714,14,182,7,14,321,349,670
141820715,14,182,7,15,465,480,945
141820716,14,182,7,16,359,350,709
141820801,14,182,8,1,398,390,788
141820802,14,182,8,2,372,436,808
141820803,14,182,8,3,470,480,950
141820804,14,182,8,4,311,330,641
141820805,14,182,8,5,443,518,961
141820806,14,182,8,6,531,533,1064
141820807,14,182,8,7,265,331,596
141820808,14,182,8,8,225,230,455
141820809,14,182,8,9,402,480,882
141820810,14,182,8,10,378,470,848
141820811,14,182,8,11,242,325,567
141820812,14,182,8,12,137,168,305
141820901,14,182,9,1,454,476,930
141820902,14,182,9,2,612,623,1235
141820903,14,182,9,3,560,531,1091
141820904,14,182,9,4,351,370,721
141820905,14,182,9,5,400,392,792
141820906,14,182,9,6,290,354,644
141820907,14,182,9,7,346,355,701
141820908,14,182,9,8,629,628,1257
141820909,14,182,9,9,537,527,1064
141820910,14,182,9,10,477,551,1028
141820911,14,182,9,11,312,402,714
141821001,14,182,10,1,259,332,591
141821002,14,182,10,2,399,411,810
141821003,14,182,10,3,298,306,604
141821004,14,182,10,4,504,513,1017
141821005,14,182,10,5,323,285,608
141821006,14,182,10,6,362,336,698
141821007,14,182,10,7,334,411,745
141821008,14,182,10,8,210,264,474
141821009,14,182,10,9,378,432,810
141821010,14,182,10,10,541,570,1111
141821101,14,182,11,1,200,226,426
141821102,14,182,11,2,269,329,598
141821103,14,182,11,3,214,234,448
141821104,14,182,11,4,235,311,546
141821105,14,182,11,5,204,252,456
141821106,14,182,11,6,437,422,859
141821107,14,182,11,7,262,307,569
141821108,14,182,11,8,441,429,870
141821109,14,182,11,9,775,725,1500
141821110,14,182,11,10,496,557,1053
141821201,14,182,12,1,342,370,712
141821202,14,182,12,2,237,242,479
141821203,14,182,12,3,357,399,756
141821204,14,182,12,4,542,587,1129
141821205,14,182,12,5,344,353,697
141821206,14,182,12,6,594,545,1139
141821207,14,182,12,7,380,400,780
141821208,14,182,12,8,286,339,625
141821209,14,182,12,9,329,312,641
141821210,14,182,12,10,315,337,652
141821211,14,182,12,11,444,445,889
141821301,14,182,13,1,467,482,949
141821302,14,182,13,2,451,493,944
141821303,14,182,13,3,280,345,625
141821304,14,182,13,4,389,423,812
141821305,14,182,13,5,258,289,547
141821306,14,182,13,6,349,373,722
141821307,14,182,13,7,445,506,951
141821308,14,182,13,8,229,225,454
141821309,14,182,13,9,222,240,462
141821310,14,182,13,10,242,249,491
141821311,14,182,13,11,417,417,834
141821312,14,182,13,12,420,434,854
