codigo,prov,dpto,frac,rad,1,2,3,total
140070101,14,7,1,1,8,6,3,17
140070102,14,7,1,2,31,33,57,121
140070103,14,7,1,3,43,24,12,79
140070104,14,7,1,4,8,12,3,23
140070105,14,7,1,5,33,19,18,70
140070106,14,7,1,6,17,3,11,31
140070107,14,7,1,7,6,3,1,10
140070108,14,7,1,8,45,54,12,111
140070110,14,7,1,10,68,42,23,133
140070111,14,7,1,11,96,69,14,179
140070112,14,7,1,12,73,54,39,166
140070113,14,7,1,13,93,41,28,162
140070201,14,7,2,1,44,31,15,90
140070202,14,7,2,2,17,6,8,31
140070203,14,7,2,3,17,10,4,31
140070204,14,7,2,4,56,37,46,139
140070205,14,7,2,5,130,19,5,154
140070206,14,7,2,6,226,44,42,312
140070207,14,7,2,7,207,46,11,264
140070208,14,7,2,8,190,59,15,264
140070209,14,7,2,9,155,36,5,196
140070210,14,7,2,10,131,22,0,153
140070211,14,7,2,11,187,68,26,281
140070212,14,7,2,12,159,22,1,182
140070213,14,7,2,13,144,29,1,174
140070214,14,7,2,14,164,30,1,195
140070215,14,7,2,15,131,36,7,174
140070216,14,7,2,16,58,11,8,77
140070301,14,7,3,1,4,5,7,16
140070302,14,7,3,2,7,4,6,17
140070303,14,7,3,3,0,2,3,5
140070304,14,7,3,4,2,11,4,17
140070305,14,7,3,5,17,17,50,84
140070306,14,7,3,6,10,11,7,28
140070307,14,7,3,7,19,8,5,32
140070308,14,7,3,8,34,36,3,73
140070309,14,7,3,9,82,160,24,266
140070310,14,7,3,10,112,76,11,199
140070311,14,7,3,11,90,124,26,240
140070312,14,7,3,12,109,111,27,247
140070401,14,7,4,1,8,5,2,15
140070402,14,7,4,2,3,2,2,7
140070403,14,7,4,3,17,3,4,24
140070404,14,7,4,4,0,2,0,2
140070405,14,7,4,5,18,12,17,47
140070406,14,7,4,6,35,22,7,64
140070407,14,7,4,7,45,17,15,77
140070408,14,7,4,8,9,5,6,20
140070409,14,7,4,9,1,0,12,13
140070410,14,7,4,10,6,2,1,9
140070411,14,7,4,11,7,4,8,19
140070412,14,7,4,12,6,3,23,32
140070413,14,7,4,13,15,4,4,23
140070414,14,7,4,14,82,36,105,223
140070415,14,7,4,15,32,14,10,56
140070416,14,7,4,16,73,45,11,129
140070501,14,7,5,1,104,75,26,205
140070502,14,7,5,2,64,45,4,113
140070503,14,7,5,3,89,66,11,166
140070504,14,7,5,4,97,51,2,150
140070505,14,7,5,5,107,70,3,180
140070506,14,7,5,6,132,73,15,220
140070507,14,7,5,7,54,74,28,156
140070508,14,7,5,8,67,72,10,149
140070509,14,7,5,9,182,79,2,263
140070510,14,7,5,10,194,126,7,327
140070511,14,7,5,11,168,127,3,298
140070512,14,7,5,12,172,98,6,276
140070513,14,7,5,13,200,45,3,248
140070514,14,7,5,14,75,93,5,173
140070515,14,7,5,15,94,71,10,175
140070516,14,7,5,16,44,58,15,117
140070517,14,7,5,17,120,112,48,280
140070518,14,7,5,18,50,60,89,199
140070601,14,7,6,1,6,3,4,13
140070602,14,7,6,2,27,21,17,65
140070603,14,7,6,3,5,13,27,45
140070604,14,7,6,4,8,5,5,18
140070605,14,7,6,5,38,21,6,65
140070606,14,7,6,6,31,31,0,62
140070607,14,7,6,7,137,104,14,255
140070608,14,7,6,8,125,91,11,227
140070609,14,7,6,9,61,80,10,151
140070610,14,7,6,10,97,23,12,132
140070611,14,7,6,11,139,70,5,214
140070612,14,7,6,12,111,49,3,163
140070613,14,7,6,13,87,36,2,125
140070614,14,7,6,14,145,74,24,243
140070615,14,7,6,15,89,39,8,136
140070616,14,7,6,16,71,38,0,109
140070701,14,7,7,1,3,13,8,24
140070702,14,7,7,2,7,9,10,26
140070703,14,7,7,3,1,4,8,13
140070704,14,7,7,4,1,4,1,6
140070705,14,7,7,5,5,8,16,29
140070706,14,7,7,6,141,121,17,279
140070707,14,7,7,7,4,7,2,13
140070708,14,7,7,8,2,5,7,14
140070709,14,7,7,9,0,2,4,6
140070710,14,7,7,10,2,6,4,12
140070711,14,7,7,11,1,6,5,12
140070712,14,7,7,12,2,7,5,14
140070713,14,7,7,13,3,15,9,27
140070714,14,7,7,14,2,2,2,6
140070715,14,7,7,15,8,38,22,68
140070716,14,7,7,16,10,1,2,13
140070717,14,7,7,17,4,0,4,8
140070718,14,7,7,18,17,6,5,28
140070719,14,7,7,19,68,87,22,177
140070720,14,7,7,20,8,7,4,19
140070801,14,7,8,1,0,3,7,10
140070802,14,7,8,2,23,16,23,62
140070803,14,7,8,3,111,147,10,268
140070804,14,7,8,4,39,22,4,65
140070805,14,7,8,5,122,168,45,335
140070806,14,7,8,6,110,84,8,202
140070807,14,7,8,7,88,174,8,270
140070808,14,7,8,8,157,124,7,288
140070809,14,7,8,9,155,79,12,246
140070810,14,7,8,10,11,12,11,34
140070811,14,7,8,11,1,7,6,14
140070812,14,7,8,12,3,6,6,15
140070813,14,7,8,13,7,5,4,16
140070814,14,7,8,14,84,214,32,330
140070815,14,7,8,15,162,149,22,333
140070816,14,7,8,16,106,101,3,210
140070817,14,7,8,17,176,143,15,334
140070818,14,7,8,18,98,170,7,275
140070819,14,7,8,19,9,21,5,35
140070820,14,7,8,20,86,79,13,178
140070901,14,7,9,1,1,3,6,10
140070902,14,7,9,2,1,8,16,25
140070903,14,7,9,3,0,9,5,14
140070904,14,7,9,4,101,130,12,243
140070905,14,7,9,5,6,7,1,14
140070906,14,7,9,6,4,13,10,27
140070907,14,7,9,7,1,7,4,12
140070908,14,7,9,8,26,60,4,90
140140101,14,14,1,1,35,91,28,154
140140102,14,14,1,2,66,157,41,264
140140103,14,14,1,3,123,172,35,330
140140104,14,14,1,4,53,98,48,199
140140105,14,14,1,5,139,157,2,298
140140106,14,14,1,6,146,162,16,324
140140107,14,14,1,7,98,120,7,225
140140108,14,14,1,8,132,66,4,202
140140109,14,14,1,9,172,156,17,345
140140110,14,14,1,10,220,50,1,271
140140111,14,14,1,11,108,64,0,172
140140112,14,14,1,12,205,97,4,306
140140113,14,14,1,13,115,171,28,314
140140201,14,14,2,1,52,170,5,227
140140202,14,14,2,2,357,89,4,450
140140203,14,14,2,3,225,115,3,343
140140204,14,14,2,4,229,40,0,269
140140205,14,14,2,5,214,7,0,221
140140206,14,14,2,6,128,50,2,180
140140207,14,14,2,7,224,124,2,350
140140208,14,14,2,8,267,12,0,279
140140209,14,14,2,9,139,97,1,237
140140210,14,14,2,10,192,62,1,255
140140211,14,14,2,11,138,41,0,179
140140212,14,14,2,12,94,134,1,229
140140213,14,14,2,13,251,90,1,342
140140214,14,14,2,14,221,94,3,318
140140215,14,14,2,15,124,218,8,350
140140301,14,14,3,1,60,41,21,122
140140302,14,14,3,2,108,249,134,491
140140303,14,14,3,3,170,134,82,386
140140304,14,14,3,4,64,111,157,332
140140305,14,14,3,5,80,132,47,259
140140306,14,14,3,6,70,128,23,221
140140307,14,14,3,7,88,108,14,210
140140308,14,14,3,8,87,159,64,310
140140309,14,14,3,9,89,131,121,341
140140310,14,14,3,10,191,54,3,248
140140311,14,14,3,11,167,92,3,262
140140312,14,14,3,12,227,124,1,352
140140313,14,14,3,13,119,202,9,330
140140401,14,14,4,1,84,231,58,373
140140402,14,14,4,2,74,139,44,257
140140403,14,14,4,3,43,38,11,92
140140404,14,14,4,4,90,148,11,249
140140405,14,14,4,5,50,384,13,447
140140406,14,14,4,6,117,211,65,393
140140407,14,14,4,7,167,114,1,282
140140408,14,14,4,8,164,247,2,413
140140409,14,14,4,9,161,110,12,283
140140410,14,14,4,10,108,156,69,333
140140411,14,14,4,11,94,225,59,378
140140501,14,14,5,1,93,88,59,240
140140502,14,14,5,2,86,192,11,289
140140503,14,14,5,3,24,171,7,202
140140504,14,14,5,4,18,261,23,302
140140505,14,14,5,5,242,129,27,398
140140506,14,14,5,6,84,76,21,181
140140507,14,14,5,7,75,110,18,203
140140508,14,14,5,8,150,178,28,356
140140509,14,14,5,9,154,49,10,213
140140510,14,14,5,10,114,239,22,375
140140511,14,14,5,11,149,135,16,300
140140512,14,14,5,12,99,166,26,291
140140513,14,14,5,13,87,198,41,326
140140514,14,14,5,14,81,198,25,304
140140515,14,14,5,15,148,224,4,376
140140601,14,14,6,1,56,89,57,202
140140602,14,14,6,2,16,22,5,43
140140603,14,14,6,3,7,41,14,62
140140604,14,14,6,4,26,65,118,209
140140605,14,14,6,5,77,35,101,213
140140606,14,14,6,6,99,125,37,261
140140607,14,14,6,7,101,219,68,388
140140608,14,14,6,8,42,55,47,144
140140609,14,14,6,9,122,131,42,295
140140610,14,14,6,10,68,183,37,288
140140701,14,14,7,1,183,131,15,329
140140702,14,14,7,2,77,126,8,211
140140703,14,14,7,3,56,108,4,168
140140704,14,14,7,4,34,175,40,249
140140705,14,14,7,5,50,195,53,298
140140706,14,14,7,6,3,3,7,13
140140707,14,14,7,7,5,117,60,182
140140708,14,14,7,8,33,179,68,280
140140709,14,14,7,9,88,237,29,354
140140710,14,14,7,10,12,21,26,59
140140711,14,14,7,11,23,95,49,167
140140712,14,14,7,12,20,19,77,116
140140713,14,14,7,13,33,199,12,244
140140714,14,14,7,14,19,223,20,262
140140715,14,14,7,15,11,212,8,231
140140801,14,14,8,1,1,1,1,3
140140802,14,14,8,2,122,80,0,202
140140803,14,14,8,3,75,34,2,111
140140804,14,14,8,4,27,87,171,285
140140805,14,14,8,5,235,161,47,443
140140806,14,14,8,6,119,108,6,233
140140807,14,14,8,7,215,60,5,280
140140808,14,14,8,8,43,114,19,176
140140809,14,14,8,9,91,206,111,408
140140810,14,14,8,10,84,137,110,331
140140811,14,14,8,11,49,203,68,320
140140812,14,14,8,12,75,144,20,239
140140901,14,14,9,1,0,0,10,10
140140902,14,14,9,2,74,164,70,308
140140903,14,14,9,3,11,91,174,276
140140904,14,14,9,4,97,121,7,225
140140905,14,14,9,5,103,236,24,363
140140906,14,14,9,6,112,75,16,203
140140907,14,14,9,7,86,46,2,134
140140908,14,14,9,8,132,216,2,350
140140909,14,14,9,9,165,187,17,369
140140910,14,14,9,10,126,187,15,328
140140911,14,14,9,11,164,201,20,385
140140912,14,14,9,12,181,195,63,439
140140913,14,14,9,13,135,158,13,306
140140914,14,14,9,14,18,196,24,238
140140915,14,14,9,15,1,0,12,13
140141001,14,14,10,1,127,29,0,156
140141002,14,14,10,2,243,177,20,440
140141003,14,14,10,3,104,111,0,215
140141004,14,14,10,4,124,123,0,247
140141005,14,14,10,5,113,72,4,189
140141006,14,14,10,6,190,154,8,352
140141007,14,14,10,7,90,61,1,152
140141008,14,14,10,8,214,218,6,438
140141009,14,14,10,9,158,162,0,320
140141010,14,14,10,10,161,135,11,307
140141011,14,14,10,11,147,210,21,378
140141012,14,14,10,12,180,42,2,224
140141013,14,14,10,13,98,163,14,275
140141014,14,14,10,14,112,74,0,186
140141015,14,14,10,15,128,85,0,213
140141016,14,14,10,16,166,97,1,264
140141017,14,14,10,17,159,65,1,225
140141018,14,14,10,18,132,60,1,193
140141101,14,14,11,1,63,28,13,104
140141102,14,14,11,2,108,104,12,224
140141103,14,14,11,3,110,136,13,259
140141104,14,14,11,4,111,74,10,195
140141105,14,14,11,5,154,89,22,265
140141106,14,14,11,6,109,93,24,226
140141107,14,14,11,7,111,71,36,218
140141108,14,14,11,8,7,223,17,247
140141109,14,14,11,9,36,238,110,384
140141110,14,14,11,10,123,76,11,210
140141111,14,14,11,11,71,143,66,280
140141201,14,14,12,1,51,83,100,234
140141202,14,14,12,2,138,163,15,316
140141203,14,14,12,3,114,181,17,312
140141204,14,14,12,4,117,222,8,347
140141205,14,14,12,5,213,138,23,374
140141206,14,14,12,6,112,96,32,240
140141207,14,14,12,7,137,116,3,256
140141208,14,14,12,8,193,116,6,315
140141209,14,14,12,9,188,119,9,316
140141301,14,14,13,1,60,52,4,116
140141302,14,14,13,2,110,216,7,333
140141303,14,14,13,3,125,125,12,262
140141304,14,14,13,4,123,188,17,328
140141305,14,14,13,5,37,143,26,206
140141306,14,14,13,6,32,92,52,176
140141307,14,14,13,7,68,219,33,320
140141308,14,14,13,8,64,190,20,274
140141309,14,14,13,9,71,315,31,417
140141310,14,14,13,10,45,44,62,151
140141401,14,14,14,1,90,154,74,318
140141402,14,14,14,2,114,239,101,454
140141403,14,14,14,3,73,212,47,332
140141404,14,14,14,4,46,94,50,190
140141405,14,14,14,5,37,176,25,238
140141406,14,14,14,6,145,157,26,328
140141407,14,14,14,7,212,119,17,348
140141408,14,14,14,8,3,3,4,10
140141501,14,14,15,1,156,42,2,200
140141502,14,14,15,2,185,56,0,241
140141503,14,14,15,3,89,97,1,187
140141504,14,14,15,4,86,159,2,247
140141505,14,14,15,5,155,138,0,293
140141506,14,14,15,6,72,364,10,446
140141507,14,14,15,7,114,79,1,194
140141508,14,14,15,8,143,65,27,235
140141509,14,14,15,9,249,142,1,392
140141510,14,14,15,10,118,168,26,312
140141511,14,14,15,11,209,163,6,378
140141512,14,14,15,12,125,62,1,188
140141513,14,14,15,13,336,105,13,454
140141514,14,14,15,14,174,152,7,333
140141515,14,14,15,15,185,49,9,243
140141516,14,14,15,16,20,73,62,155
140141517,14,14,15,17,61,96,145,302
140141518,14,14,15,18,164,58,0,222
140141519,14,14,15,19,149,92,5,246
140141520,14,14,15,20,132,132,83,347
140141601,14,14,16,1,107,184,39,330
140141602,14,14,16,2,73,303,21,397
140141603,14,14,16,3,67,119,229,415
140141604,14,14,16,4,47,86,44,177
140141605,14,14,16,5,69,117,62,248
140141606,14,14,16,6,64,167,72,303
140141607,14,14,16,7,73,156,62,291
140141608,14,14,16,8,51,99,21,171
140141609,14,14,16,9,60,109,22,191
140141610,14,14,16,10,113,100,32,245
140141611,14,14,16,11,11,162,78,251
140141612,14,14,16,12,15,44,188,247
140141613,14,14,16,13,26,72,156,254
140141614,14,14,16,14,29,79,139,247
140141615,14,14,16,15,33,64,128,225
140141616,14,14,16,16,12,56,453,521
140141617,14,14,16,17,48,93,152,293
140141618,14,14,16,18,41,308,31,380
140141701,14,14,17,1,233,124,30,387
140141702,14,14,17,2,170,111,10,291
140141703,14,14,17,3,96,133,30,259
140141704,14,14,17,4,142,186,40,368
140141705,14,14,17,5,203,78,16,297
140141706,14,14,17,6,250,127,23,400
140141707,14,14,17,7,54,110,45,209
140141708,14,14,17,8,78,167,50,295
140141709,14,14,17,9,78,133,9,220
140141710,14,14,17,10,178,135,17,330
140141711,14,14,17,11,170,138,15,323
140141712,14,14,17,12,99,118,23,240
140141713,14,14,17,13,150,207,60,417
140141714,14,14,17,14,110,129,11,250
140141715,14,14,17,15,131,149,90,370
140141716,14,14,17,16,73,250,82,405
140141717,14,14,17,17,146,225,64,435
140141718,14,14,17,18,135,155,40,330
140141719,14,14,17,19,120,122,24,266
140141720,14,14,17,20,113,62,6,181
140141721,14,14,17,21,205,144,22,371
140141801,14,14,18,1,149,162,70,381
140141802,14,14,18,2,33,210,20,263
140141803,14,14,18,3,58,193,12,263
140141804,14,14,18,4,66,138,8,212
140141805,14,14,18,5,119,216,51,386
140141806,14,14,18,6,73,73,67,213
140141807,14,14,18,7,70,126,20,216
140141808,14,14,18,8,173,227,46,446
140141809,14,14,18,9,220,84,22,326
140141810,14,14,18,10,99,139,5,243
140141811,14,14,18,11,171,144,14,329
140141812,14,14,18,12,145,127,33,305
140141813,14,14,18,13,177,117,2,296
140141814,14,14,18,14,137,180,9,326
140141815,14,14,18,15,73,142,36,251
140141816,14,14,18,16,82,211,127,420
140141817,14,14,18,17,26,214,3,243
140141818,14,14,18,18,22,218,4,244
140141901,14,14,19,1,191,156,13,360
140141902,14,14,19,2,71,133,25,229
140141903,14,14,19,3,88,110,36,234
140141904,14,14,19,4,104,108,69,281
140141905,14,14,19,5,60,65,86,211
140141906,14,14,19,6,137,170,28,335
140141907,14,14,19,7,68,283,19,370
140141908,14,14,19,8,53,158,198,409
140141909,14,14,19,9,54,135,103,292
140141910,14,14,19,10,46,133,13,192
140141911,14,14,19,11,176,202,13,391
140141912,14,14,19,12,15,132,78,225
140141913,14,14,19,13,149,174,5,328
140141914,14,14,19,14,84,201,39,324
140141915,14,14,19,15,227,177,13,417
140141916,14,14,19,16,211,148,21,380
140141917,14,14,19,17,142,76,8,226
140141918,14,14,19,18,184,46,6,236
140141919,14,14,19,19,6,33,197,236
140142001,14,14,20,1,115,106,27,248
140142002,14,14,20,2,151,77,5,233
140142003,14,14,20,3,169,78,4,251
140142004,14,14,20,4,212,82,15,309
140142005,14,14,20,5,264,93,11,368
140142006,14,14,20,6,123,99,14,236
140142007,14,14,20,7,143,90,13,246
140142008,14,14,20,8,126,76,2,204
140142009,14,14,20,9,124,92,1,217
140142010,14,14,20,10,125,121,5,251
140142011,14,14,20,11,156,63,1,220
140142012,14,14,20,12,217,74,1,292
140142013,14,14,20,13,190,80,5,275
140142014,14,14,20,14,194,79,2,275
140142015,14,14,20,15,91,94,0,185
140142016,14,14,20,16,260,95,12,367
140142101,14,14,21,1,179,52,41,272
140142102,14,14,21,2,201,53,21,275
140142103,14,14,21,3,190,52,10,252
140142104,14,14,21,4,316,60,2,378
140142105,14,14,21,5,180,26,1,207
140142201,14,14,22,1,156,41,0,197
140142202,14,14,22,2,261,53,4,318
140142203,14,14,22,3,153,48,1,202
140142204,14,14,22,4,161,31,5,197
140142205,14,14,22,5,89,29,0,118
140142206,14,14,22,6,248,161,6,415
140142207,14,14,22,7,168,30,3,201
140142208,14,14,22,8,150,180,5,335
140142209,14,14,22,9,79,150,1,230
140142210,14,14,22,10,150,137,1,288
140142211,14,14,22,11,134,142,2,278
140142212,14,14,22,12,230,58,1,289
140142213,14,14,22,13,1,0,2,3
140142214,14,14,22,14,170,58,0,228
140142215,14,14,22,15,234,73,0,307
140142216,14,14,22,16,220,60,2,282
140142217,14,14,22,17,136,99,63,298
140142218,14,14,22,18,132,81,180,393
140142301,14,14,23,1,159,38,3,200
140142302,14,14,23,2,191,90,3,284
140142303,14,14,23,3,147,66,1,214
140142304,14,14,23,4,109,75,1,185
140142305,14,14,23,5,120,44,8,172
140142306,14,14,23,6,170,85,0,255
140142307,14,14,23,7,149,98,1,248
140142308,14,14,23,8,253,69,19,341
140142309,14,14,23,9,123,42,1,166
140142310,14,14,23,10,202,52,2,256
140142311,14,14,23,11,174,40,0,214
140142312,14,14,23,12,172,72,1,245
140142313,14,14,23,13,356,90,2,448
140142314,14,14,23,14,124,101,17,242
140142315,14,14,23,15,184,74,5,263
140142316,14,14,23,16,131,61,2,194
140142401,14,14,24,1,176,154,1,331
140142402,14,14,24,2,239,91,0,330
140142403,14,14,24,3,254,36,0,290
140142404,14,14,24,4,304,106,2,412
140142405,14,14,24,5,191,63,1,255
140142406,14,14,24,6,221,78,1,300
140142407,14,14,24,7,187,60,4,251
140142408,14,14,24,8,158,86,0,244
140142409,14,14,24,9,190,96,1,287
140142410,14,14,24,10,123,57,0,180
140142411,14,14,24,11,129,92,1,222
140142412,14,14,24,12,127,56,0,183
140142413,14,14,24,13,160,54,3,217
140142414,14,14,24,14,170,28,0,198
140142501,14,14,25,1,235,33,1,269
140142502,14,14,25,2,94,87,0,181
140142503,14,14,25,3,53,35,0,88
140142504,14,14,25,4,165,148,5,318
140142505,14,14,25,5,113,114,3,230
140142506,14,14,25,6,164,158,3,325
140142507,14,14,25,7,165,138,7,310
140142508,14,14,25,8,77,95,3,175
140142509,14,14,25,9,110,73,6,189
140142510,14,14,25,10,121,64,1,186
140142511,14,14,25,11,101,137,2,240
140142512,14,14,25,12,157,73,1,231
140142513,14,14,25,13,195,36,0,231
140142514,14,14,25,14,135,71,2,208
140142515,14,14,25,15,244,99,0,343
140142516,14,14,25,16,184,129,1,314
140142517,14,14,25,17,87,128,6,221
140142518,14,14,25,18,174,132,2,308
140142601,14,14,26,1,119,88,10,217
140142602,14,14,26,2,52,119,4,175
140142603,14,14,26,3,171,51,3,225
140142604,14,14,26,4,77,88,1,166
140142605,14,14,26,5,113,54,5,172
140142606,14,14,26,6,80,142,7,229
140142607,14,14,26,7,94,128,4,226
140142608,14,14,26,8,171,166,5,342
140142609,14,14,26,9,128,120,16,264
140142610,14,14,26,10,73,117,4,194
140142611,14,14,26,11,207,143,11,361
140142612,14,14,26,12,170,105,1,276
140142613,14,14,26,13,141,53,8,202
140142614,14,14,26,14,107,129,3,239
140142615,14,14,26,15,148,152,5,305
140142616,14,14,26,16,174,61,4,239
140142701,14,14,27,1,88,140,3,231
140142702,14,14,27,2,117,169,16,302
140142703,14,14,27,3,134,152,30,316
140142704,14,14,27,4,74,164,5,243
140142705,14,14,27,5,75,104,0,179
140142706,14,14,27,6,117,99,3,219
140142707,14,14,27,7,184,85,6,275
140142708,14,14,27,8,120,172,3,295
140142709,14,14,27,9,58,132,7,197
140142710,14,14,27,10,95,175,7,277
140142711,14,14,27,11,147,102,3,252
140142712,14,14,27,12,103,98,4,205
140142801,14,14,28,1,250,130,1,381
140142802,14,14,28,2,190,116,1,307
140142803,14,14,28,3,257,102,1,360
140142804,14,14,28,4,226,168,4,398
140142805,14,14,28,5,220,88,2,310
140142806,14,14,28,6,163,34,55,252
140142807,14,14,28,7,90,128,6,224
140142808,14,14,28,8,210,148,5,363
140142809,14,14,28,9,132,145,7,284
140142810,14,14,28,10,123,166,19,308
140142811,14,14,28,11,112,147,11,270
140142812,14,14,28,12,138,95,5,238
140142813,14,14,28,13,128,185,26,339
140142814,14,14,28,14,52,153,106,311
140142815,14,14,28,15,183,56,7,246
140142816,14,14,28,16,100,135,183,418
140142901,14,14,29,1,170,134,0,304
140142902,14,14,29,2,139,120,2,261
140142903,14,14,29,3,199,67,8,274
140142904,14,14,29,4,105,147,27,279
140142905,14,14,29,5,103,180,26,309
140142906,14,14,29,6,262,101,0,363
140142907,14,14,29,7,121,100,2,223
140142908,14,14,29,8,132,123,5,260
140142909,14,14,29,9,155,95,32,282
140142910,14,14,29,10,82,137,40,259
140142911,14,14,29,11,79,98,23,200
140142912,14,14,29,12,70,137,39,246
140142913,14,14,29,13,121,121,4,246
140142914,14,14,29,14,145,123,4,272
140142915,14,14,29,15,150,221,11,382
140142916,14,14,29,16,156,121,8,285
140142917,14,14,29,17,97,193,15,305
140142918,14,14,29,18,55,96,63,214
140142919,14,14,29,19,54,103,51,208
140143001,14,14,30,1,106,139,14,259
140143002,14,14,30,2,144,220,14,378
140143003,14,14,30,3,165,71,5,241
140143004,14,14,30,4,95,183,37,315
140143005,14,14,30,5,35,129,22,186
140143006,14,14,30,6,116,119,15,250
140143007,14,14,30,7,22,95,19,136
140143008,14,14,30,8,125,137,11,273
140143009,14,14,30,9,188,167,7,362
140143010,14,14,30,10,118,147,4,269
140143011,14,14,30,11,129,144,4,277
140143012,14,14,30,12,125,166,12,303
140143013,14,14,30,13,184,105,8,297
140143014,14,14,30,14,94,193,23,310
140143015,14,14,30,15,135,98,19,252
140143101,14,14,31,1,85,162,14,261
140143102,14,14,31,2,108,193,75,376
140143103,14,14,31,3,85,267,33,385
140143104,14,14,31,4,27,259,3,289
140143105,14,14,31,5,100,200,6,306
140143106,14,14,31,6,96,150,8,254
140143107,14,14,31,7,203,207,4,414
140143108,14,14,31,8,116,168,3,287
140143109,14,14,31,9,188,152,33,373
140143110,14,14,31,10,87,116,25,228
140143111,14,14,31,11,131,97,8,236
140143112,14,14,31,12,80,231,32,343
140143113,14,14,31,13,142,115,9,266
140143114,14,14,31,14,97,157,9,263
140143115,14,14,31,15,68,149,7,224
140143116,14,14,31,16,90,197,18,305
140143201,14,14,32,1,89,121,6,216
140143202,14,14,32,2,213,155,16,384
140143203,14,14,32,3,111,111,1,223
140143204,14,14,32,4,109,109,8,226
140143205,14,14,32,5,121,176,17,314
140143206,14,14,32,6,178,115,17,310
140143207,14,14,32,7,194,151,12,357
140143208,14,14,32,8,63,161,26,250
140143209,14,14,32,9,128,92,5,225
140143210,14,14,32,10,184,218,11,413
140143211,14,14,32,11,101,125,39,265
140143212,14,14,32,12,88,121,6,215
140143213,14,14,32,13,167,103,1,271
140143301,14,14,33,1,120,121,18,259
140143302,14,14,33,2,147,59,2,208
140143303,14,14,33,3,104,138,7,249
140143304,14,14,33,4,106,86,12,204
140143305,14,14,33,5,73,129,10,212
140143306,14,14,33,6,83,104,9,196
140143307,14,14,33,7,178,115,2,295
140143308,14,14,33,8,193,130,9,332
140143309,14,14,33,9,110,129,7,246
140143310,14,14,33,10,68,172,1,241
140143311,14,14,33,11,125,136,2,263
140143312,14,14,33,12,151,84,5,240
140143313,14,14,33,13,155,87,9,251
140143314,14,14,33,14,126,84,5,215
140143315,14,14,33,15,145,114,8,267
140143316,14,14,33,16,112,82,4,198
140143317,14,14,33,17,157,148,5,310
140143318,14,14,33,18,210,153,0,363
140143319,14,14,33,19,128,114,31,273
140143320,14,14,33,20,131,74,3,208
140143401,14,14,34,1,120,84,14,218
140143402,14,14,34,2,213,59,7,279
140143403,14,14,34,3,189,63,0,252
140143404,14,14,34,4,92,41,0,133
140143405,14,14,34,5,82,81,4,167
140143406,14,14,34,6,105,58,5,168
140143407,14,14,34,7,144,48,4,196
140143408,14,14,34,8,102,86,5,193
140143409,14,14,34,9,196,40,9,245
140143410,14,14,34,10,151,38,3,192
140143411,14,14,34,11,115,75,2,192
140143412,14,14,34,12,151,72,3,226
140143413,14,14,34,13,165,62,2,229
140143414,14,14,34,14,126,62,7,195
140143415,14,14,34,15,144,48,5,197
140143416,14,14,34,16,209,16,1,226
140143417,14,14,34,17,125,64,1,190
140143418,14,14,34,18,223,111,6,340
140143419,14,14,34,19,120,64,2,186
140143501,14,14,35,1,52,190,3,245
140143502,14,14,35,2,204,201,12,417
140143503,14,14,35,3,81,118,3,202
140143504,14,14,35,4,203,166,0,369
140143505,14,14,35,5,134,47,0,181
140143506,14,14,35,6,1,170,507,678
140143507,14,14,35,7,88,242,5,335
140143508,14,14,35,8,159,92,3,254
140143509,14,14,35,9,142,77,7,226
140143510,14,14,35,10,56,152,4,212
140143511,14,14,35,11,155,127,7,289
140143512,14,14,35,12,70,169,11,250
140143513,14,14,35,13,152,53,4,209
140143514,14,14,35,14,169,135,14,318
140143601,14,14,36,1,138,102,1,241
140143602,14,14,36,2,167,61,0,228
140143603,14,14,36,3,137,165,9,311
140143604,14,14,36,4,145,151,2,298
140143605,14,14,36,5,168,111,2,281
140143606,14,14,36,6,158,77,2,237
140143607,14,14,36,7,129,124,2,255
140143608,14,14,36,8,164,91,2,257
140143609,14,14,36,9,137,65,2,204
140143610,14,14,36,10,70,120,2,192
140143611,14,14,36,11,99,142,7,248
140143612,14,14,36,12,142,103,4,249
140143613,14,14,36,13,144,61,1,206
140143614,14,14,36,14,121,87,0,208
140143701,14,14,37,1,239,119,8,366
140143702,14,14,37,2,43,99,10,152
140143703,14,14,37,3,53,132,18,203
140143704,14,14,37,4,91,119,13,223
140143705,14,14,37,5,119,86,10,215
140143706,14,14,37,6,85,101,24,210
140143707,14,14,37,7,146,118,6,270
140143708,14,14,37,8,157,128,12,297
140143709,14,14,37,9,96,120,4,220
140143710,14,14,37,10,126,79,6,211
140143711,14,14,37,11,229,165,9,403
140143712,14,14,37,12,92,128,12,232
140143713,14,14,37,13,109,106,4,219
140143714,14,14,37,14,80,94,6,180
140143715,14,14,37,15,171,37,2,210
140143716,14,14,37,16,100,77,6,183
140143717,14,14,37,17,91,60,34,185
140143718,14,14,37,18,80,76,6,162
140143719,14,14,37,19,151,56,0,207
140143720,14,14,37,20,145,55,1,201
140143721,14,14,37,21,91,66,2,159
140143801,14,14,38,1,172,170,8,350
140143802,14,14,38,2,177,125,2,304
140143803,14,14,38,3,188,136,0,324
140143804,14,14,38,4,143,152,4,299
140143805,14,14,38,5,136,80,0,216
140143806,14,14,38,6,160,88,2,250
140143807,14,14,38,7,150,98,1,249
140143808,14,14,38,8,227,125,7,359
140143809,14,14,38,9,117,110,7,234
140143810,14,14,38,10,197,94,2,293
140143811,14,14,38,11,141,112,2,255
140143812,14,14,38,12,61,151,3,215
140143813,14,14,38,13,136,149,1,286
140143814,14,14,38,14,190,103,1,294
140143815,14,14,38,15,166,75,2,243
140143816,14,14,38,16,161,59,2,222
140143901,14,14,39,1,71,93,7,171
140143902,14,14,39,2,193,98,81,372
140143903,14,14,39,3,229,104,0,333
140143904,14,14,39,4,144,63,1,208
140143905,14,14,39,5,111,79,0,190
140143906,14,14,39,6,153,61,3,217
140143907,14,14,39,7,93,89,15,197
140143908,14,14,39,8,148,108,3,259
140143909,14,14,39,9,197,74,8,279
140143910,14,14,39,10,193,61,2,256
140143911,14,14,39,11,136,99,2,237
140143912,14,14,39,12,176,134,3,313
140143913,14,14,39,13,79,74,13,166
140144001,14,14,40,1,121,121,3,245
140144002,14,14,40,2,107,96,7,210
140144003,14,14,40,3,111,108,4,223
140144004,14,14,40,4,80,106,2,188
140144005,14,14,40,5,85,70,1,156
140144006,14,14,40,6,125,49,1,175
140144007,14,14,40,7,172,49,4,225
140144008,14,14,40,8,180,82,26,288
140144009,14,14,40,9,104,103,7,214
140144010,14,14,40,10,129,94,4,227
140144011,14,14,40,11,131,66,7,204
140144012,14,14,40,12,140,82,4,226
140144101,14,14,41,1,192,59,0,251
140144102,14,14,41,2,145,49,3,197
140144103,14,14,41,3,220,88,4,312
140144104,14,14,41,4,119,72,2,193
140144105,14,14,41,5,127,81,2,210
140144106,14,14,41,6,172,64,2,238
140144107,14,14,41,7,168,46,3,217
140144108,14,14,41,8,111,43,3,157
140144109,14,14,41,9,155,50,2,207
140144110,14,14,41,10,199,84,2,285
140144111,14,14,41,11,99,82,1,182
140144112,14,14,41,12,237,51,2,290
140144113,14,14,41,13,184,97,2,283
140144114,14,14,41,14,171,135,1,307
140144115,14,14,41,15,147,102,2,251
140144116,14,14,41,16,177,17,1,195
140144117,14,14,41,17,164,88,2,254
140144118,14,14,41,18,182,40,1,223
140144119,14,14,41,19,149,54,1,204
140144201,14,14,42,1,114,77,0,191
140144202,14,14,42,2,109,26,1,136
140144203,14,14,42,3,99,39,0,138
140144204,14,14,42,4,98,74,0,172
140144205,14,14,42,5,139,43,1,183
140144206,14,14,42,6,202,23,1,226
140144207,14,14,42,7,240,30,0,270
140144208,14,14,42,8,287,86,0,373
140144209,14,14,42,9,149,50,0,199
140144210,14,14,42,10,132,58,1,191
140144211,14,14,42,11,160,76,1,237
140144212,14,14,42,12,174,99,1,274
140144213,14,14,42,13,147,74,0,221
140144214,14,14,42,14,268,31,0,299
140144215,14,14,42,15,159,42,0,201
140144216,14,14,42,16,234,61,18,313
140144217,14,14,42,17,196,45,0,241
140144218,14,14,42,18,99,102,38,239
140144219,14,14,42,19,212,103,4,319
140144220,14,14,42,20,234,84,2,320
140144301,14,14,43,1,211,108,3,322
140144302,14,14,43,2,156,207,50,413
140144303,14,14,43,3,104,117,75,296
140144304,14,14,43,4,76,143,106,325
140144305,14,14,43,5,41,72,46,159
140144306,14,14,43,6,126,165,64,355
140144307,14,14,43,7,73,148,53,274
140144308,14,14,43,8,67,163,106,336
140144309,14,14,43,9,167,143,12,322
140144310,14,14,43,10,135,83,3,221
140144311,14,14,43,11,204,69,1,274
140144401,14,14,44,1,452,67,0,519
140144402,14,14,44,2,141,96,2,239
140144403,14,14,44,3,143,120,7,270
140144404,14,14,44,4,85,101,3,189
140144405,14,14,44,5,166,37,1,204
140144406,14,14,44,6,272,173,2,447
140144407,14,14,44,7,213,97,1,311
140144408,14,14,44,8,189,9,1,199
140144409,14,14,44,9,95,96,72,263
140144410,14,14,44,10,159,82,6,247
140144411,14,14,44,11,218,171,12,401
140144501,14,14,45,1,123,123,79,325
140144502,14,14,45,2,185,189,54,428
140144503,14,14,45,3,122,82,35,239
140144504,14,14,45,4,157,123,12,292
140144505,14,14,45,5,253,40,3,296
140144506,14,14,45,6,203,91,0,294
140144507,14,14,45,7,218,94,14,326
140144508,14,14,45,8,200,86,0,286
140144509,14,14,45,9,276,48,0,324
140144510,14,14,45,10,215,154,6,375
140144511,14,14,45,11,167,99,6,272
140144512,14,14,45,12,167,83,13,263
140144513,14,14,45,13,98,90,0,188
140144601,14,14,46,1,49,159,24,232
140144602,14,14,46,2,178,133,41,352
140144603,14,14,46,3,113,103,5,221
140144604,14,14,46,4,93,93,10,196
140144605,14,14,46,5,80,111,11,202
140144606,14,14,46,6,99,155,8,262
140144607,14,14,46,7,104,106,4,214
140144608,14,14,46,8,141,73,5,219
140144609,14,14,46,9,135,129,12,276
140144610,14,14,46,10,132,111,15,258
140144611,14,14,46,11,189,88,19,296
140144612,14,14,46,12,175,67,6,248
140144613,14,14,46,13,65,68,8,141
140144614,14,14,46,14,144,144,21,309
140144615,14,14,46,15,116,147,8,271
140144616,14,14,46,16,88,122,23,233
140144701,14,14,47,1,74,55,4,133
140144702,14,14,47,2,84,71,4,159
140144703,14,14,47,3,212,80,0,292
140144704,14,14,47,4,105,49,3,157
140144705,14,14,47,5,110,52,3,165
140144706,14,14,47,6,162,49,2,213
140144707,14,14,47,7,159,97,5,261
140144708,14,14,47,8,172,103,15,290
140144709,14,14,47,9,130,45,12,187
140144710,14,14,47,10,112,77,2,191
140144711,14,14,47,11,154,65,3,222
140144712,14,14,47,12,359,55,3,417
140144801,14,14,48,1,125,49,0,174
140144802,14,14,48,2,195,71,0,266
140144803,14,14,48,3,176,91,5,272
140144804,14,14,48,4,143,74,23,240
140144805,14,14,48,5,183,49,2,234
140144806,14,14,48,6,68,120,1,189
140144807,14,14,48,7,237,60,1,298
140144808,14,14,48,8,175,43,0,218
140144809,14,14,48,9,114,42,2,158
140144810,14,14,48,10,249,80,1,330
140144811,14,14,48,11,183,70,0,253
140144812,14,14,48,12,136,81,6,223
140144813,14,14,48,13,223,33,2,258
140144814,14,14,48,14,149,80,4,233
140144815,14,14,48,15,242,120,10,372
140144816,14,14,48,16,174,83,1,258
140144901,14,14,49,1,78,53,4,135
140144902,14,14,49,2,82,79,7,168
140144903,14,14,49,3,96,43,6,145
140144904,14,14,49,4,90,82,5,177
140144905,14,14,49,5,134,68,4,206
140144906,14,14,49,6,51,77,2,130
140144907,14,14,49,7,204,105,23,332
140144908,14,14,49,8,173,100,26,299
140144909,14,14,49,9,213,90,7,310
140144910,14,14,49,10,99,48,0,147
140144911,14,14,49,11,70,26,0,96
140144912,14,14,49,12,146,21,1,168
140144913,14,14,49,13,238,91,1,330
140144914,14,14,49,14,169,51,2,222
140144915,14,14,49,15,170,74,2,246
140144916,14,14,49,16,238,107,0,345
140144917,14,14,49,17,121,30,0,151
140144918,14,14,49,18,136,20,0,156
140144919,14,14,49,19,188,29,0,217
140144920,14,14,49,20,121,76,1,198
140144921,14,14,49,21,219,70,0,289
140145001,14,14,50,1,126,119,5,250
140145002,14,14,50,2,142,114,27,283
140145003,14,14,50,3,120,88,1,209
140145004,14,14,50,4,120,90,10,220
140145005,14,14,50,5,133,76,4,213
140145006,14,14,50,6,102,103,2,207
140145007,14,14,50,7,197,76,0,273
140145008,14,14,50,8,181,50,4,235
140145009,14,14,50,9,281,76,0,357
140145010,14,14,50,10,153,93,1,247
140145011,14,14,50,11,195,50,10,255
140145012,14,14,50,12,145,46,4,195
140145013,14,14,50,13,101,90,1,192
140145014,14,14,50,14,157,80,0,237
140145015,14,14,50,15,166,96,0,262
140145101,14,14,51,1,182,79,1,262
140145102,14,14,51,2,120,106,5,231
140145103,14,14,51,3,91,93,3,187
140145104,14,14,51,4,102,138,2,242
140145105,14,14,51,5,155,62,6,223
140145106,14,14,51,6,185,121,1,307
140145107,14,14,51,7,96,167,10,273
140145108,14,14,51,8,92,146,5,243
140145109,14,14,51,9,175,126,3,304
140145110,14,14,51,10,85,124,7,216
140145111,14,14,51,11,109,131,3,243
140145112,14,14,51,12,164,149,5,318
140145113,14,14,51,13,129,135,31,295
140145114,14,14,51,14,100,135,10,245
140145115,14,14,51,15,54,114,14,182
140145116,14,14,51,16,70,46,27,143
140145117,14,14,51,17,139,159,25,323
140145118,14,14,51,18,146,88,14,248
140145119,14,14,51,19,147,153,31,331
140145120,14,14,51,20,128,120,237,485
140145121,14,14,51,21,16,62,163,241
140145201,14,14,52,1,177,44,0,221
140145202,14,14,52,2,206,120,2,328
140145203,14,14,52,3,71,136,4,211
140145204,14,14,52,4,66,119,209,394
140145205,14,14,52,5,116,40,1,157
140145206,14,14,52,6,125,62,1,188
140145207,14,14,52,7,165,51,0,216
140145208,14,14,52,8,156,53,1,210
140145209,14,14,52,9,45,136,3,184
140145210,14,14,52,10,113,65,4,182
140145211,14,14,52,11,66,77,5,148
140145212,14,14,52,12,77,161,44,282
140145213,14,14,52,13,156,60,7,223
140145214,14,14,52,14,154,75,7,236
140145215,14,14,52,15,103,52,1,156
140145216,14,14,52,16,96,112,18,226
140145217,14,14,52,17,39,106,60,205
140145218,14,14,52,18,84,150,29,263
140145219,14,14,52,19,128,111,13,252
140145301,14,14,53,1,157,79,4,240
140145302,14,14,53,2,145,69,0,214
140145303,14,14,53,3,85,49,0,134
140145304,14,14,53,4,154,8,1,163
140145305,14,14,53,5,156,15,5,176
140145306,14,14,53,6,229,38,1,268
140145307,14,14,53,7,169,45,1,215
140145308,14,14,53,8,210,75,7,292
140145309,14,14,53,9,121,94,3,218
140145310,14,14,53,10,197,71,6,274
140145311,14,14,53,11,170,75,0,245
140145312,14,14,53,12,175,25,2,202
140145313,14,14,53,13,106,71,2,179
140145314,14,14,53,14,117,55,3,175
140145315,14,14,53,15,235,101,0,336
140145316,14,14,53,16,89,70,0,159
140145317,14,14,53,17,81,87,1,169
140145318,14,14,53,18,151,46,0,197
140145319,14,14,53,19,157,36,4,197
140145320,14,14,53,20,91,42,2,135
140145401,14,14,54,1,98,46,2,146
140145402,14,14,54,2,76,78,21,175
140145403,14,14,54,3,112,90,0,202
140145404,14,14,54,4,176,29,0,205
140145405,14,14,54,5,88,46,1,135
140145406,14,14,54,6,228,35,0,263
140145407,14,14,54,7,130,20,0,150
140145408,14,14,54,8,117,51,0,168
140145409,14,14,54,9,132,90,0,222
140145410,14,14,54,10,112,40,0,152
140145411,14,14,54,11,66,48,0,114
140145412,14,14,54,12,174,34,0,208
140145413,14,14,54,13,281,116,0,397
140145414,14,14,54,14,214,38,0,252
140145415,14,14,54,15,175,39,1,215
140145416,14,14,54,16,171,24,0,195
140145501,14,14,55,1,121,97,3,221
140145502,14,14,55,2,111,77,24,212
140145503,14,14,55,3,56,22,2,80
140145504,14,14,55,4,98,23,0,121
140145505,14,14,55,5,66,72,0,138
140145506,14,14,55,6,98,7,0,105
140145507,14,14,55,7,109,37,0,146
140145508,14,14,55,8,21,33,0,54
140145509,14,14,55,9,98,41,0,139
140145510,14,14,55,10,97,57,0,154
140145511,14,14,55,11,194,12,0,206
140145512,14,14,55,12,77,66,0,143
140145513,14,14,55,13,113,12,0,125
140145514,14,14,55,14,79,60,0,139
140145515,14,14,55,15,75,6,0,81
140145516,14,14,55,16,151,32,15,198
140145517,14,14,55,17,268,70,0,338
140145518,14,14,55,18,111,17,0,128
140145519,14,14,55,19,230,34,4,268
140145601,14,14,56,1,150,49,0,199
140145602,14,14,56,2,162,55,0,217
140145603,14,14,56,3,133,69,7,209
140145604,14,14,56,4,105,50,3,158
140145605,14,14,56,5,87,51,0,138
140145606,14,14,56,6,106,36,4,146
140145607,14,14,56,7,101,21,1,123
140145608,14,14,56,8,76,45,0,121
140145609,14,14,56,9,80,56,2,138
140145610,14,14,56,10,83,4,0,87
140145611,14,14,56,11,203,38,2,243
140145612,14,14,56,12,51,36,2,89
140145613,14,14,56,13,111,32,0,143
140145614,14,14,56,14,106,20,0,126
140145615,14,14,56,15,86,40,0,126
140145616,14,14,56,16,96,32,2,130
140145617,14,14,56,17,109,69,1,179
140145618,14,14,56,18,123,77,3,203
140145619,14,14,56,19,140,24,0,164
140145701,14,14,57,1,282,71,1,354
140145702,14,14,57,2,146,70,1,217
140145703,14,14,57,3,172,68,1,241
140145704,14,14,57,4,335,52,0,387
140145705,14,14,57,5,141,8,0,149
140145706,14,14,57,6,93,20,0,113
140145707,14,14,57,7,83,110,0,193
140145708,14,14,57,8,65,5,0,70
140145709,14,14,57,9,46,90,0,136
140145710,14,14,57,10,94,53,0,147
140145711,14,14,57,11,150,21,0,171
140145712,14,14,57,12,103,30,0,133
140145713,14,14,57,13,145,77,1,223
140145714,14,14,57,14,203,56,0,259
140145715,14,14,57,15,270,37,0,307
140145716,14,14,57,16,101,4,0,105
140145801,14,14,58,1,81,53,2,136
140145802,14,14,58,2,191,62,5,258
140145803,14,14,58,3,93,51,3,147
140145804,14,14,58,4,170,49,0,219
140145805,14,14,58,5,122,104,10,236
140145806,14,14,58,6,175,106,2,283
140145807,14,14,58,7,124,66,2,192
140145808,14,14,58,8,224,41,5,270
140145809,14,14,58,9,202,58,0,260
140145810,14,14,58,10,53,64,0,117
140145811,14,14,58,11,248,47,4,299
140145812,14,14,58,12,224,39,2,265
140145813,14,14,58,13,77,12,1,90
140145901,14,14,59,1,117,93,21,231
140145902,14,14,59,2,124,25,0,149
140145903,14,14,59,3,154,127,3,284
140145904,14,14,59,4,183,81,2,266
140145905,14,14,59,5,52,156,10,218
140145906,14,14,59,6,133,67,16,216
140145907,14,14,59,7,128,65,2,195
140145908,14,14,59,8,76,36,6,118
140145909,14,14,59,9,119,85,4,208
140145910,14,14,59,10,153,51,2,206
140145911,14,14,59,11,111,45,1,157
140145912,14,14,59,12,238,76,0,314
140146001,14,14,60,1,128,121,15,264
140146002,14,14,60,2,136,97,9,242
140146003,14,14,60,3,130,72,2,204
140146004,14,14,60,4,219,64,5,288
140146005,14,14,60,5,229,116,2,347
140146006,14,14,60,6,158,90,4,252
140146007,14,14,60,7,144,52,6,202
140146008,14,14,60,8,106,63,12,181
140146009,14,14,60,9,195,61,4,260
140146010,14,14,60,10,157,44,8,209
140146011,14,14,60,11,295,64,1,360
140146012,14,14,60,12,110,50,1,161
140146013,14,14,60,13,115,100,2,217
140146014,14,14,60,14,201,151,6,358
140146015,14,14,60,15,204,109,15,328
140146016,14,14,60,16,128,111,3,242
140146017,14,14,60,17,198,125,3,326
140146018,14,14,60,18,169,133,2,304
140146101,14,14,61,1,64,136,67,267
140146102,14,14,61,2,36,174,45,255
140146103,14,14,61,3,45,145,23,213
140146104,14,14,61,4,44,106,42,192
140146105,14,14,61,5,39,90,155,284
140146106,14,14,61,6,103,113,2,218
140146107,14,14,61,7,40,108,71,219
140146108,14,14,61,8,109,121,26,256
140146109,14,14,61,9,96,117,8,221
140146110,14,14,61,10,101,104,6,211
140146111,14,14,61,11,110,90,58,258
140146112,14,14,61,12,169,174,84,427
140146113,14,14,61,13,75,184,75,334
140146114,14,14,61,14,29,70,124,223
140146115,14,14,61,15,43,81,115,239
140146201,14,14,62,1,149,90,0,239
140146202,14,14,62,2,206,67,4,277
140146203,14,14,62,3,154,96,4,254
140146204,14,14,62,4,109,95,10,214
140146205,14,14,62,5,125,78,5,208
140146206,14,14,62,6,198,44,2,244
140146207,14,14,62,7,134,88,7,229
140146208,14,14,62,8,145,90,1,236
140146209,14,14,62,9,221,97,3,321
140146210,14,14,62,10,196,111,2,309
140146211,14,14,62,11,155,138,82,375
140146212,14,14,62,12,123,161,8,292
140146213,14,14,62,13,121,121,16,258
140146301,14,14,63,1,118,85,6,209
140146302,14,14,63,2,182,33,0,215
140146303,14,14,63,3,162,34,1,197
140146304,14,14,63,4,169,49,3,221
140146305,14,14,63,5,194,155,2,351
140146306,14,14,63,6,173,111,3,287
140146307,14,14,63,7,211,58,7,276
140146308,14,14,63,8,178,88,1,267
140146309,14,14,63,9,99,166,1,266
140146310,14,14,63,10,138,64,3,205
140146311,14,14,63,11,128,72,2,202
140146312,14,14,63,12,63,105,0,168
140146313,14,14,63,13,103,98,3,204
140146401,14,14,64,1,121,80,4,205
140146402,14,14,64,2,282,96,5,383
140146403,14,14,64,3,198,89,5,292
140146404,14,14,64,4,271,25,26,322
140146405,14,14,64,5,132,65,35,232
140146406,14,14,64,6,130,85,1,216
140146407,14,14,64,7,235,112,3,350
140146408,14,14,64,8,200,90,6,296
140146409,14,14,64,9,208,108,5,321
140146410,14,14,64,10,209,88,8,305
140146411,14,14,64,11,87,145,13,245
140146501,14,14,65,1,128,81,0,209
140146502,14,14,65,2,222,82,4,308
140146503,14,14,65,3,149,53,0,202
140146504,14,14,65,4,74,69,0,143
140146505,14,14,65,5,127,79,1,207
140146506,14,14,65,6,189,79,0,268
140146507,14,14,65,7,65,59,35,159
140146508,14,14,65,8,117,25,2,144
140146509,14,14,65,9,115,69,1,185
140146510,14,14,65,10,122,55,2,179
140146511,14,14,65,11,86,151,23,260
140146512,14,14,65,12,195,104,2,301
140146513,14,14,65,13,119,44,7,170
140146514,14,14,65,14,176,178,11,365
140146515,14,14,65,15,69,45,33,147
140146516,14,14,65,16,155,129,11,295
140146601,14,14,66,1,258,43,2,303
140146602,14,14,66,2,276,43,7,326
140146603,14,14,66,3,125,5,1,131
140146604,14,14,66,4,207,23,2,232
140146605,14,14,66,5,143,46,1,190
140146606,14,14,66,6,185,42,1,228
140146607,14,14,66,7,207,29,4,240
140146608,14,14,66,8,56,19,1,76
140146609,14,14,66,9,162,56,1,219
140146610,14,14,66,10,132,27,1,160
140146611,14,14,66,11,109,23,0,132
140146612,14,14,66,12,171,39,1,211
140146613,14,14,66,13,137,26,1,164
140146614,14,14,66,14,274,60,1,335
140146701,14,14,67,1,152,56,1,209
140146702,14,14,67,2,85,14,0,99
140146703,14,14,67,3,252,105,1,358
140146704,14,14,67,4,98,71,0,169
140146705,14,14,67,5,177,29,0,206
140146706,14,14,67,6,238,65,1,304
140146707,14,14,67,7,186,15,0,201
140146708,14,14,67,8,196,59,0,255
140146709,14,14,67,9,213,49,0,262
140146710,14,14,67,10,208,19,0,227
140146711,14,14,67,11,441,21,0,462
140146801,14,14,68,1,144,45,0,189
140146802,14,14,68,2,93,45,1,139
140146803,14,14,68,3,213,94,3,310
140146804,14,14,68,4,375,53,2,430
140146805,14,14,68,5,87,31,0,118
140146806,14,14,68,6,217,25,11,253
140146807,14,14,68,7,122,38,1,161
140146808,14,14,68,8,57,20,4,81
140146809,14,14,68,9,193,72,4,269
140146810,14,14,68,10,158,46,4,208
140146811,14,14,68,11,68,36,1,105
140146812,14,14,68,12,116,36,13,165
140146813,14,14,68,13,65,21,0,86
140146814,14,14,68,14,149,100,2,251
140146901,14,14,69,1,148,79,0,227
140146902,14,14,69,2,127,1,0,128
140146903,14,14,69,3,104,49,9,162
140146904,14,14,69,4,174,42,1,217
140146905,14,14,69,5,186,51,0,237
140146906,14,14,69,6,142,54,11,207
140146907,14,14,69,7,123,72,3,198
140146908,14,14,69,8,93,89,27,209
140146909,14,14,69,9,168,1,0,169
140146910,14,14,69,10,132,39,4,175
140146911,14,14,69,11,296,70,27,393
140146912,14,14,69,12,168,8,0,176
140146913,14,14,69,13,71,14,0,85
140146914,14,14,69,14,314,33,1,348
140147001,14,14,70,1,227,59,1,287
140147002,14,14,70,2,243,23,0,266
140147003,14,14,70,3,230,95,1,326
140147004,14,14,70,4,166,23,0,189
140147005,14,14,70,5,307,28,0,335
140147006,14,14,70,6,250,87,1,338
140147007,14,14,70,7,170,81,0,251
140147008,14,14,70,8,229,38,1,268
140147009,14,14,70,9,225,8,2,235
140147010,14,14,70,10,282,51,1,334
140147011,14,14,70,11,167,44,1,212
140147101,14,14,71,1,118,58,0,176
140147102,14,14,71,2,299,72,1,372
140147103,14,14,71,3,201,80,0,281
140147104,14,14,71,4,305,68,1,374
140147105,14,14,71,5,219,58,0,277
140147106,14,14,71,6,231,120,7,358
140147107,14,14,71,7,340,77,0,417
140147108,14,14,71,8,188,63,0,251
140147109,14,14,71,9,306,100,1,407
140147110,14,14,71,10,309,96,0,405
140147111,14,14,71,11,171,85,0,256
140147201,14,14,72,1,444,159,3,606
140147202,14,14,72,2,608,94,5,707
140147203,14,14,72,3,477,155,0,632
140147204,14,14,72,4,443,122,0,565
140147205,14,14,72,5,207,28,0,235
140147206,14,14,72,6,417,162,0,579
140147207,14,14,72,7,466,199,5,670
140147301,14,14,73,1,128,45,8,181
140147302,14,14,73,2,114,92,1,207
140147303,14,14,73,3,82,104,5,191
140147304,14,14,73,4,128,96,2,226
140147305,14,14,73,5,137,83,0,220
140147306,14,14,73,6,139,93,17,249
140147307,14,14,73,7,28,46,79,153
140147308,14,14,73,8,148,54,17,219
140147309,14,14,73,9,169,106,10,285
140147310,14,14,73,10,108,73,1,182
140147311,14,14,73,11,148,71,3,222
140147312,14,14,73,12,92,104,6,202
140147313,14,14,73,13,107,102,3,212
140147401,14,14,74,1,53,154,49,256
140147402,14,14,74,2,96,100,46,242
140147403,14,14,74,3,59,123,13,195
140147404,14,14,74,4,113,88,11,212
140147405,14,14,74,5,54,158,14,226
140147406,14,14,74,6,131,160,27,318
140147407,14,14,74,7,91,159,9,259
140147408,14,14,74,8,95,176,6,277
140147409,14,14,74,9,64,169,2,235
140147410,14,14,74,10,85,135,16,236
140147411,14,14,74,11,107,117,84,308
140147412,14,14,74,12,119,203,4,326
140147413,14,14,74,13,120,115,0,235
140147414,14,14,74,14,126,147,2,275
140147415,14,14,74,15,149,120,11,280
140147416,14,14,74,16,119,84,4,207
140147417,14,14,74,17,152,102,0,254
140147418,14,14,74,18,169,72,4,245
140147501,14,14,75,1,8,148,167,323
140147502,14,14,75,2,65,89,36,190
140147503,14,14,75,3,97,95,50,242
140147504,14,14,75,4,49,95,65,209
140147505,14,14,75,5,49,128,45,222
140147506,14,14,75,6,53,184,56,293
140147507,14,14,75,7,115,160,35,310
140147508,14,14,75,8,124,73,28,225
140147509,14,14,75,9,138,105,34,277
140147510,14,14,75,10,161,138,16,315
140147511,14,14,75,11,115,151,38,304
140147512,14,14,75,12,46,140,31,217
140147513,14,14,75,13,134,199,79,412
140147514,14,14,75,14,77,205,96,378
140147515,14,14,75,15,108,238,40,386
140147516,14,14,75,16,81,137,18,236
140147517,14,14,75,17,123,150,14,287
140147518,14,14,75,18,24,122,148,294
140147519,14,14,75,19,60,268,54,382
140147601,14,14,76,1,123,189,9,321
140147602,14,14,76,2,158,129,8,295
140147603,14,14,76,3,88,135,15,238
140147604,14,14,76,4,107,156,10,273
140147605,14,14,76,5,99,161,15,275
140147606,14,14,76,6,191,325,24,540
140147607,14,14,76,7,158,92,13,263
140147608,14,14,76,8,182,62,5,249
140147609,14,14,76,9,159,104,11,274
140147610,14,14,76,10,175,109,2,286
140147611,14,14,76,11,166,111,4,281
140147612,14,14,76,12,184,106,14,304
140147613,14,14,76,13,86,102,19,207
140147614,14,14,76,14,144,110,11,265
140147615,14,14,76,15,171,48,19,238
140147616,14,14,76,16,122,200,32,354
140147617,14,14,76,17,172,108,20,300
140147701,14,14,77,1,184,141,7,332
140147702,14,14,77,2,151,74,10,235
140147703,14,14,77,3,88,78,65,231
140147704,14,14,77,4,140,107,5,252
140147705,14,14,77,5,172,107,4,283
140147706,14,14,77,6,172,75,4,251
140147707,14,14,77,7,248,95,2,345
140147708,14,14,77,8,172,95,3,270
140147709,14,14,77,9,158,93,4,255
140147710,14,14,77,10,172,106,3,281
140147711,14,14,77,11,99,109,2,210
140147712,14,14,77,12,109,136,15,260
140147713,14,14,77,13,149,154,79,382
140147714,14,14,77,14,96,96,17,209
140147715,14,14,77,15,80,195,11,286
140147716,14,14,77,16,63,145,4,212
140147717,14,14,77,17,128,122,42,292
140147718,14,14,77,18,139,84,6,229
140147719,14,14,77,19,33,163,46,242
140147720,14,14,77,20,190,116,3,309
140147721,14,14,77,21,81,95,4,180
140147722,14,14,77,22,96,123,28,247
140147801,14,14,78,1,134,185,9,328
140147802,14,14,78,2,91,73,13,177
140147803,14,14,78,3,111,109,6,226
140147804,14,14,78,4,110,100,12,222
140147805,14,14,78,5,126,88,11,225
140147806,14,14,78,6,88,33,2,123
140147807,14,14,78,7,108,141,8,257
140147808,14,14,78,8,172,97,2,271
140147809,14,14,78,9,128,122,13,263
140147810,14,14,78,10,192,93,4,289
140147811,14,14,78,11,235,143,0,378
140147812,14,14,78,12,180,79,12,271
140147813,14,14,78,13,148,49,2,199
140147814,14,14,78,14,370,45,1,416
140147815,14,14,78,15,119,59,1,179
140147816,14,14,78,16,105,27,23,155
140147901,14,14,79,1,201,92,4,297
140147902,14,14,79,2,208,70,3,281
140147903,14,14,79,3,143,58,8,209
140147904,14,14,79,4,130,65,4,199
140147905,14,14,79,5,186,38,1,225
140147906,14,14,79,6,189,106,0,295
140147907,14,14,79,7,136,172,7,315
140147908,14,14,79,8,113,97,4,214
140147909,14,14,79,9,237,137,0,374
140147910,14,14,79,10,118,91,14,223
140147911,14,14,79,11,116,130,20,266
140147912,14,14,79,12,83,67,8,158
140147913,14,14,79,13,56,130,43,229
140147914,14,14,79,14,74,100,4,178
140147915,14,14,79,15,110,169,42,321
140147916,14,14,79,16,206,68,0,274
140147917,14,14,79,17,150,125,2,277
140147918,14,14,79,18,133,93,3,229
140147919,14,14,79,19,79,142,3,224
140147920,14,14,79,20,121,117,10,248
140148001,14,14,80,1,227,16,0,243
140148002,14,14,80,2,183,33,0,216
140148003,14,14,80,3,87,93,0,180
140148004,14,14,80,4,121,61,0,182
140148005,14,14,80,5,236,3,0,239
140148006,14,14,80,6,278,92,2,372
140148007,14,14,80,7,103,52,0,155
140148008,14,14,80,8,116,34,3,153
140148009,14,14,80,9,166,28,1,195
140148010,14,14,80,10,194,40,0,234
140148011,14,14,80,11,141,50,1,192
140148012,14,14,80,12,133,42,0,175
140148013,14,14,80,13,59,64,12,135
140148014,14,14,80,14,28,60,40,128
140148101,14,14,81,1,184,73,1,258
140148102,14,14,81,2,235,62,0,297
140148103,14,14,81,3,549,34,0,583
140148104,14,14,81,4,508,24,9,541
140148105,14,14,81,5,465,53,2,520
140148106,14,14,81,6,566,103,2,671
140148107,14,14,81,7,181,41,2,224
140148108,14,14,81,8,221,44,0,265
140148109,14,14,81,9,223,16,0,239
140148110,14,14,81,10,143,32,8,183
140148201,14,14,82,1,259,47,0,306
140148202,14,14,82,2,314,79,1,394
140148203,14,14,82,3,290,25,2,317
140148204,14,14,82,4,460,70,1,531
140148205,14,14,82,5,131,70,1,202
140148206,14,14,82,6,117,32,0,149
140148207,14,14,82,7,259,71,0,330
140148208,14,14,82,8,454,129,3,586
140148209,14,14,82,9,254,50,0,304
140148210,14,14,82,10,146,44,3,193
140148211,14,14,82,11,191,20,0,211
140148301,14,14,83,1,143,107,9,259
140148302,14,14,83,2,165,114,7,286
140148303,14,14,83,3,120,122,11,253
140148304,14,14,83,4,93,117,18,228
140148305,14,14,83,5,99,86,23,208
140148306,14,14,83,6,49,99,14,162
140148307,14,14,83,7,190,72,18,280
140148308,14,14,83,8,62,72,19,153
140148309,14,14,83,9,233,64,4,301
140148310,14,14,83,10,124,47,6,177
140148311,14,14,83,11,100,104,16,220
140148312,14,14,83,12,95,155,26,276
140148313,14,14,83,13,128,71,17,216
140148314,14,14,83,14,145,88,20,253
140148315,14,14,83,15,79,105,0,184
140148316,14,14,83,16,125,31,3,159
140148401,14,14,84,1,114,140,10,264
140148402,14,14,84,2,177,75,2,254
140148403,14,14,84,3,142,116,2,260
140148404,14,14,84,4,111,61,2,174
140148405,14,14,84,5,156,101,2,259
140148406,14,14,84,6,116,54,2,172
140148407,14,14,84,7,88,66,3,157
140148408,14,14,84,8,121,98,2,221
140148409,14,14,84,9,164,58,1,223
140148410,14,14,84,10,114,110,4,228
140148411,14,14,84,11,166,48,2,216
140148412,14,14,84,12,137,110,3,250
140148501,14,14,85,1,120,138,1,259
140148502,14,14,85,2,136,85,1,222
140148503,14,14,85,3,149,62,1,212
140148504,14,14,85,4,174,80,1,255
140148505,14,14,85,5,223,73,1,297
140148506,14,14,85,6,145,163,6,314
140148507,14,14,85,7,156,54,1,211
140148508,14,14,85,8,219,151,17,387
140148509,14,14,85,9,155,208,11,374
140148510,14,14,85,10,234,83,11,328
140148511,14,14,85,11,58,220,61,339
140148512,14,14,85,12,37,182,51,270
140148513,14,14,85,13,120,134,54,308
140148514,14,14,85,14,155,175,1,331
140148515,14,14,85,15,126,72,2,200
140148516,14,14,85,16,192,91,0,283
140148601,14,14,86,1,12,81,106,199
140148602,14,14,86,2,36,69,46,151
140148603,14,14,86,3,68,123,28,219
140148604,14,14,86,4,53,136,112,301
140148605,14,14,86,5,94,162,78,334
140148606,14,14,86,6,79,124,67,270
140148607,14,14,86,7,75,171,32,278
140148608,14,14,86,8,79,126,30,235
140148609,14,14,86,9,22,111,120,253
140148610,14,14,86,10,65,134,136,335
140148611,14,14,86,11,75,118,8,201
140148612,14,14,86,12,85,104,19,208
140148701,14,14,87,1,208,79,10,297
140148702,14,14,87,2,137,121,8,266
140148703,14,14,87,3,86,77,12,175
140148704,14,14,87,4,84,119,18,221
140148705,14,14,87,5,108,241,33,382
140148706,14,14,87,6,51,130,17,198
140148707,14,14,87,7,97,106,20,223
140148708,14,14,87,8,98,252,19,369
140148709,14,14,87,9,108,66,8,182
140148710,14,14,87,10,134,62,19,215
140148711,14,14,87,11,110,117,40,267
140148712,14,14,87,12,122,130,28,280
140148713,14,14,87,13,93,62,11,166
140148801,14,14,88,1,103,128,1,232
140148802,14,14,88,2,169,118,3,290
140148803,14,14,88,3,162,97,5,264
140148804,14,14,88,4,143,91,8,242
140148805,14,14,88,5,81,40,1,122
140148806,14,14,88,6,126,138,8,272
140148807,14,14,88,7,187,104,0,291
140148808,14,14,88,8,127,116,5,248
140148809,14,14,88,9,115,134,1,250
140148810,14,14,88,10,143,124,4,271
140148811,14,14,88,11,154,185,12,351
140148812,14,14,88,12,152,113,3,268
140148813,14,14,88,13,131,135,6,272
140148814,14,14,88,14,45,296,1,342
140148815,14,14,88,15,143,183,1,327
140148901,14,14,89,1,191,50,4,245
140148902,14,14,89,2,156,37,1,194
140148903,14,14,89,3,228,146,4,378
140148904,14,14,89,4,282,76,0,358
140148905,14,14,89,5,137,71,7,215
140148906,14,14,89,6,182,120,3,305
140148907,14,14,89,7,165,91,0,256
140148908,14,14,89,8,169,38,0,207
140148909,14,14,89,9,169,92,1,262
140148910,14,14,89,10,176,47,3,226
140148911,14,14,89,11,91,89,11,191
140148912,14,14,89,12,96,104,14,214
140148913,14,14,89,13,189,63,2,254
140148914,14,14,89,14,159,62,2,223
140148915,14,14,89,15,292,69,5,366
140148916,14,14,89,16,118,237,23,378
140149001,14,14,90,1,138,61,9,208
140149002,14,14,90,2,88,70,51,209
140149003,14,14,90,3,83,79,8,170
140149004,14,14,90,4,148,32,1,181
140149005,14,14,90,5,101,104,7,212
140149006,14,14,90,6,125,115,23,263
140149007,14,14,90,7,153,125,44,322
140149008,14,14,90,8,178,26,1,205
140149009,14,14,90,9,208,42,1,251
140149010,14,14,90,10,134,39,1,174
140149011,14,14,90,11,160,33,16,209
140149012,14,14,90,12,109,99,47,255
140149013,14,14,90,13,63,130,119,312
140149014,14,14,90,14,150,77,4,231
140149015,14,14,90,15,183,82,0,265
140149101,14,14,91,1,253,113,4,370
140149102,14,14,91,2,212,92,1,305
140149103,14,14,91,3,132,100,12,244
140149104,14,14,91,4,213,124,12,349
140149105,14,14,91,5,113,89,4,206
140149106,14,14,91,6,146,176,2,324
140149107,14,14,91,7,187,112,19,318
140149108,14,14,91,8,148,113,1,262
140149109,14,14,91,9,175,13,3,191
140149110,14,14,91,10,129,180,2,311
140149111,14,14,91,11,206,63,6,275
140149112,14,14,91,12,240,58,1,299
140149113,14,14,91,13,139,137,12,288
140149114,14,14,91,14,173,208,7,388
140149115,14,14,91,15,156,135,4,295
140149116,14,14,91,16,155,67,3,225
140149117,14,14,91,17,199,59,2,260
140149118,14,14,91,18,124,172,0,296
140149119,14,14,91,19,184,107,5,296
140149120,14,14,91,20,110,117,0,227
140149201,14,14,92,1,211,82,1,294
140149202,14,14,92,2,89,65,0,154
140149203,14,14,92,3,149,26,1,176
140149204,14,14,92,4,60,139,17,216
140149205,14,14,92,5,82,135,3,220
140149206,14,14,92,6,71,141,2,214
140149207,14,14,92,7,81,85,13,179
140149208,14,14,92,8,117,57,7,181
140149209,14,14,92,9,148,117,4,269
140149210,14,14,92,10,171,73,3,247
140149211,14,14,92,11,135,102,1,238
140149212,14,14,92,12,182,112,2,296
140149213,14,14,92,13,66,87,4,157
140149214,14,14,92,14,190,104,3,297
140149215,14,14,92,15,168,71,0,239
140149216,14,14,92,16,140,122,1,263
140149217,14,14,92,17,170,95,4,269
140149218,14,14,92,18,190,24,1,215
140149301,14,14,93,1,171,57,5,233
140149302,14,14,93,2,155,85,0,240
140149303,14,14,93,3,134,185,14,333
140149304,14,14,93,4,120,231,28,379
140149305,14,14,93,5,127,117,8,252
140149306,14,14,93,6,199,100,38,337
140149307,14,14,93,7,104,154,10,268
140149308,14,14,93,8,212,169,8,389
140149309,14,14,93,9,149,89,11,249
140149310,14,14,93,10,199,128,6,333
140149311,14,14,93,11,157,193,14,364
140149312,14,14,93,12,221,176,1,398
140149313,14,14,93,13,71,143,0,214
140149314,14,14,93,14,118,50,0,168
140149315,14,14,93,15,86,132,12,230
140149316,14,14,93,16,128,92,10,230
140149317,14,14,93,17,181,189,11,381
140149318,14,14,93,18,151,146,0,297
140149319,14,14,93,19,113,127,49,289
140149320,14,14,93,20,77,65,2,144
140149321,14,14,93,21,224,39,1,264
140149401,14,14,94,1,148,128,4,280
140149402,14,14,94,2,99,129,12,240
140149403,14,14,94,3,115,59,27,201
140149404,14,14,94,4,124,234,59,417
140149405,14,14,94,5,110,222,4,336
140149406,14,14,94,6,156,88,10,254
140149407,14,14,94,7,159,192,26,377
140149408,14,14,94,8,219,172,3,394
140149409,14,14,94,9,69,180,21,270
140149410,14,14,94,10,127,81,17,225
140149411,14,14,94,11,66,146,44,256
140149412,14,14,94,12,98,131,35,264
140149413,14,14,94,13,61,163,21,245
140149414,14,14,94,14,104,71,9,184
140149501,14,14,95,1,89,122,7,218
140149502,14,14,95,2,98,129,3,230
140149503,14,14,95,3,109,72,5,186
140149504,14,14,95,4,73,176,13,262
140149505,14,14,95,5,50,247,1,298
140149506,14,14,95,6,186,97,1,284
140149507,14,14,95,7,20,221,5,246
140149508,14,14,95,8,21,276,27,324
140149509,14,14,95,9,129,118,7,254
140149510,14,14,95,10,154,173,5,332
140149511,14,14,95,11,14,79,128,221
140149512,14,14,95,12,89,217,41,347
140149513,14,14,95,13,121,174,32,327
140149514,14,14,95,14,101,219,25,345
140149601,14,14,96,1,113,118,4,235
140149602,14,14,96,2,114,92,6,212
140149603,14,14,96,3,179,115,21,315
140149604,14,14,96,4,228,75,9,312
140149605,14,14,96,5,160,67,2,229
140149606,14,14,96,6,90,92,10,192
140149607,14,14,96,7,110,87,7,204
140149608,14,14,96,8,160,114,5,279
140149609,14,14,96,9,193,64,0,257
140149610,14,14,96,10,127,168,13,308
140149611,14,14,96,11,109,132,5,246
140149612,14,14,96,12,128,176,1,305
140149613,14,14,96,13,232,97,3,332
140149614,14,14,96,14,85,129,3,217
140149615,14,14,96,15,122,77,15,214
140149616,14,14,96,16,124,169,23,316
140149617,14,14,96,17,156,200,61,417
140149701,14,14,97,1,52,238,110,400
140149702,14,14,97,2,78,82,27,187
140149703,14,14,97,3,120,83,4,207
140149704,14,14,97,4,50,126,1,177
140149705,14,14,97,5,136,77,1,214
140149706,14,14,97,6,91,258,23,372
140149707,14,14,97,7,107,89,85,281
140149708,14,14,97,8,102,186,52,340
140149709,14,14,97,9,84,181,60,325
140149710,14,14,97,10,115,120,61,296
140149711,14,14,97,11,66,192,65,323
140149712,14,14,97,12,85,117,34,236
140149713,14,14,97,13,68,73,38,179
140149714,14,14,97,14,160,223,34,417
140149715,14,14,97,15,77,190,34,301
140149716,14,14,97,16,73,119,18,210
140149717,14,14,97,17,126,200,90,416
140149801,14,14,98,1,111,128,10,249
140149802,14,14,98,2,138,142,34,314
140149803,14,14,98,3,59,113,24,196
140149804,14,14,98,4,121,84,14,219
140149805,14,14,98,5,74,61,12,147
140149806,14,14,98,6,89,130,13,232
140149807,14,14,98,7,127,196,45,368
140149808,14,14,98,8,111,80,19,210
140149809,14,14,98,9,155,123,25,303
140149810,14,14,98,10,59,101,25,185
140149811,14,14,98,11,42,144,23,209
140149812,14,14,98,12,41,116,30,187
140149813,14,14,98,13,93,186,60,339
140149901,14,14,99,1,251,46,9,306
140149902,14,14,99,2,165,142,8,315
140149903,14,14,99,3,216,99,15,330
140149904,14,14,99,4,69,129,7,205
140149905,14,14,99,5,132,64,8,204
140149906,14,14,99,6,130,138,19,287
140149907,14,14,99,7,105,114,5,224
140149908,14,14,99,8,187,177,18,382
140149909,14,14,99,9,153,124,21,298
140149910,14,14,99,10,62,215,19,296
140149911,14,14,99,11,65,105,10,180
140149912,14,14,99,12,90,88,21,199
140149913,14,14,99,13,120,210,36,366
140210101,14,21,1,1,11,9,3,23
140210102,14,21,1,2,6,15,6,27
140210103,14,21,1,3,8,27,17,52
140210104,14,21,1,4,71,27,13,111
140210105,14,21,1,5,34,30,10,74
140210106,14,21,1,6,109,55,11,175
140210107,14,21,1,7,88,60,6,154
140210108,14,21,1,8,107,38,9,154
140210109,14,21,1,9,66,82,22,170
140210110,14,21,1,10,75,39,2,116
140210201,14,21,2,1,2,10,3,15
140210202,14,21,2,2,11,7,8,26
140210203,14,21,2,3,6,6,4,16
140210204,14,21,2,4,16,20,13,49
140210205,14,21,2,5,13,60,21,94
140210206,14,21,2,6,37,40,9,86
140210207,14,21,2,7,76,64,9,149
140210208,14,21,2,8,58,34,6,98
140210209,14,21,2,9,127,66,6,199
140210210,14,21,2,10,42,73,4,119
140210211,14,21,2,11,56,30,2,88
140210212,14,21,2,12,50,55,16,121
140210213,14,21,2,13,47,49,45,141
140210301,14,21,3,1,33,11,2,46
140210302,14,21,3,2,57,57,1,115
140210303,14,21,3,3,78,71,26,175
140210304,14,21,3,4,64,131,15,210
140210305,14,21,3,5,49,63,7,119
140210306,14,21,3,6,18,70,20,108
140210307,14,21,3,7,9,30,5,44
140210308,14,21,3,8,27,59,15,101
140210309,14,21,3,9,61,72,33,166
140210310,14,21,3,10,15,51,34,100
140210311,14,21,3,11,50,49,17,116
140210312,14,21,3,12,44,61,5,110
140210313,14,21,3,13,10,46,39,95
140210314,14,21,3,14,16,144,99,259
140210315,14,21,3,15,16,80,133,229
140210316,14,21,3,16,15,107,77,199
140210401,14,21,4,1,25,28,35,88
140210402,14,21,4,2,28,21,29,78
140210403,14,21,4,3,22,38,50,110
140210404,14,21,4,4,31,53,9,93
140210405,14,21,4,5,14,31,40,85
140210406,14,21,4,6,90,130,47,267
140210407,14,21,4,7,75,167,41,283
140210408,14,21,4,8,41,20,22,83
140210409,14,21,4,9,160,168,23,351
140210410,14,21,4,10,100,102,36,238
140210501,14,21,5,1,17,13,13,43
140210502,14,21,5,2,29,29,23,81
140210503,14,21,5,3,3,5,5,13
140210504,14,21,5,4,25,13,5,43
140210505,14,21,5,5,29,13,6,48
140210506,14,21,5,6,96,25,0,121
140210507,14,21,5,7,156,57,4,217
140210508,14,21,5,8,147,84,1,232
140210601,14,21,6,1,30,19,17,66
140210602,14,21,6,2,11,8,6,25
140210603,14,21,6,3,10,7,7,24
140210604,14,21,6,4,23,17,8,48
140210605,14,21,6,5,24,32,23,79
140210606,14,21,6,6,1,2,15,18
140210607,14,21,6,7,9,25,21,55
140210608,14,21,6,8,71,112,40,223
140210609,14,21,6,9,184,91,6,281
140210610,14,21,6,10,87,54,18,159
140210611,14,21,6,11,158,177,64,399
140210612,14,21,6,12,209,124,26,359
140210613,14,21,6,13,141,98,9,248
140210614,14,21,6,14,168,191,54,413
140210615,14,21,6,15,186,149,67,402
140210616,14,21,6,16,155,118,32,305
140210701,14,21,7,1,10,22,30,62
140210702,14,21,7,2,67,54,36,157
140210703,14,21,7,3,30,36,21,87
140210704,14,21,7,4,40,100,7,147
140210705,14,21,7,5,59,196,95,350
140210706,14,21,7,6,41,159,89,289
140210707,14,21,7,7,73,134,59,266
140210708,14,21,7,8,58,143,59,260
140210709,14,21,7,9,14,182,29,225
140210710,14,21,7,10,19,142,26,187
140210711,14,21,7,11,66,147,19,232
140210712,14,21,7,12,69,96,22,187
140210713,14,21,7,13,21,19,13,53
140210714,14,21,7,14,23,63,60,146
140210715,14,21,7,15,21,92,151,264
140210716,14,21,7,16,18,74,62,154
140210801,14,21,8,1,10,20,12,42
140210802,14,21,8,2,36,40,59,135
140210803,14,21,8,3,122,140,77,339
140210804,14,21,8,4,47,178,38,263
140210805,14,21,8,5,77,156,38,271
140210806,14,21,8,6,40,55,23,118
140210807,14,21,8,7,70,166,59,295
140210808,14,21,8,8,60,121,40,221
140210809,14,21,8,9,66,177,103,346
140210810,14,21,8,10,53,110,44,207
140210811,14,21,8,11,61,117,39,217
140210812,14,21,8,12,63,113,43,219
140210813,14,21,8,13,53,120,63,236
140210814,14,21,8,14,47,103,101,251
140210901,14,21,9,1,106,115,14,235
140210902,14,21,9,2,134,77,26,237
140210903,14,21,9,3,88,118,6,212
140210904,14,21,9,4,131,64,0,195
140210905,14,21,9,5,109,71,2,182
140210906,14,21,9,6,160,93,2,255
140210907,14,21,9,7,117,76,0,193
140210908,14,21,9,8,97,64,2,163
140210909,14,21,9,9,118,70,6,194
140210910,14,21,9,10,93,117,47,257
140210911,14,21,9,11,128,222,15,365
140210912,14,21,9,12,106,77,7,190
140210913,14,21,9,13,160,87,15,262
140210914,14,21,9,14,166,145,1,312
140211001,14,21,10,1,209,166,5,380
140211002,14,21,10,2,122,128,15,265
140211003,14,21,10,3,149,135,5,289
140211004,14,21,10,4,173,166,13,352
140211005,14,21,10,5,58,119,24,201
140211006,14,21,10,6,169,137,3,309
140211007,14,21,10,7,76,92,1,169
140211008,14,21,10,8,145,106,21,272
140211009,14,21,10,9,92,137,1,230
140211010,14,21,10,10,134,154,12,300
140211011,14,21,10,11,159,149,23,331
140211012,14,21,10,12,124,271,7,402
140211013,14,21,10,13,124,171,44,339
140211014,14,21,10,14,182,201,31,414
140211015,14,21,10,15,43,75,2,120
140211016,14,21,10,16,129,86,7,222
140211101,14,21,11,1,94,114,13,221
140211102,14,21,11,2,74,124,47,245
140211103,14,21,11,3,81,111,7,199
140211104,14,21,11,4,91,141,4,236
140211105,14,21,11,5,112,134,4,250
140211106,14,21,11,6,73,36,5,114
140211107,14,21,11,7,181,60,10,251
140211108,14,21,11,8,105,157,2,264
140211109,14,21,11,9,179,187,5,371
140211110,14,21,11,10,86,89,2,177
140211111,14,21,11,11,94,99,3,196
140211112,14,21,11,12,232,133,5,370
140211113,14,21,11,13,91,170,15,276
140211114,14,21,11,14,130,82,3,215
140211115,14,21,11,15,115,93,3,211
140211116,14,21,11,16,85,129,4,218
140211117,14,21,11,17,163,99,1,263
140211118,14,21,11,18,225,111,1,337
140211119,14,21,11,19,92,185,14,291
140211201,14,21,12,1,84,71,26,181
140211202,14,21,12,2,60,52,48,160
140211203,14,21,12,3,149,96,23,268
140211204,14,21,12,4,121,75,26,222
140211205,14,21,12,5,72,88,47,207
140211206,14,21,12,6,143,73,10,226
140211207,14,21,12,7,117,59,18,194
140211208,14,21,12,8,60,58,17,135
140211209,14,21,12,9,92,39,3,134
140211210,14,21,12,10,198,48,0,246
140211211,14,21,12,11,149,91,10,250
140211212,14,21,12,12,72,49,60,181
140211213,14,21,12,13,76,98,18,192
140211214,14,21,12,14,164,83,18,265
140211301,14,21,13,1,128,82,19,229
140211302,14,21,13,2,104,42,8,154
140211303,14,21,13,3,94,75,9,178
140211304,14,21,13,4,104,54,11,169
140211305,14,21,13,5,191,84,12,287
140211306,14,21,13,6,115,66,15,196
140211307,14,21,13,7,79,62,25,166
140211308,14,21,13,8,218,94,17,329
140211309,14,21,13,9,95,41,41,177
140211310,14,21,13,10,162,57,8,227
140211311,14,21,13,11,143,48,3,194
140211312,14,21,13,12,137,54,8,199
140211313,14,21,13,13,145,102,4,251
140211314,14,21,13,14,178,86,12,276
140211401,14,21,14,1,111,94,1,206
140211402,14,21,14,2,133,30,1,164
140211403,14,21,14,3,159,25,7,191
140211404,14,21,14,4,184,99,5,288
140211405,14,21,14,5,134,111,28,273
140211406,14,21,14,6,75,108,42,225
140211407,14,21,14,7,235,109,13,357
140211408,14,21,14,8,146,48,10,204
140211409,14,21,14,9,129,52,19,200
140211410,14,21,14,10,151,73,8,232
140211411,14,21,14,11,156,97,23,276
140211412,14,21,14,12,91,109,15,215
140211501,14,21,15,1,86,95,26,207
140211502,14,21,15,2,130,95,20,245
140211503,14,21,15,3,106,76,15,197
140211504,14,21,15,4,163,87,4,254
140211505,14,21,15,5,123,63,7,193
140211506,14,21,15,6,176,100,2,278
140211507,14,21,15,7,139,63,6,208
140211508,14,21,15,8,47,48,12,107
140211509,14,21,15,9,72,63,25,160
140211510,14,21,15,10,126,48,17,191
140211511,14,21,15,11,145,48,1,194
140211601,14,21,16,1,110,118,41,269
140211602,14,21,16,2,222,132,17,371
140211603,14,21,16,3,141,68,9,218
140211604,14,21,16,4,65,115,59,239
140211605,14,21,16,5,86,89,50,225
140211606,14,21,16,6,102,79,49,230
140211607,14,21,16,7,166,85,8,259
140211608,14,21,16,8,147,91,1,239
140211609,14,21,16,9,117,74,26,217
140211610,14,21,16,10,96,93,25,214
140211611,14,21,16,11,100,194,36,330
140211701,14,21,17,1,126,65,34,225
140211702,14,21,17,2,139,53,26,218
140211703,14,21,17,3,118,66,11,195
140211704,14,21,17,4,138,74,9,221
140211705,14,21,17,5,104,74,10,188
140211706,14,21,17,6,188,91,19,298
140211707,14,21,17,7,232,59,3,294
140211708,14,21,17,8,260,109,13,382
140211709,14,21,17,9,254,100,33,387
140211710,14,21,17,10,216,94,5,315
140211801,14,21,18,1,154,58,16,228
140211802,14,21,18,2,84,80,28,192
140211803,14,21,18,3,135,32,14,181
140211804,14,21,18,4,187,87,2,276
140211805,14,21,18,5,200,79,6,285
140211806,14,21,18,6,56,110,37,203
140211807,14,21,18,7,59,107,50,216
140211808,14,21,18,8,44,124,63,231
140211809,14,21,18,9,30,111,119,260
140211810,14,21,18,10,144,114,17,275
140211811,14,21,18,11,156,55,12,223
140211812,14,21,18,12,246,117,10,373
140211813,14,21,18,13,194,153,28,375
140211814,14,21,18,14,157,57,3,217
140211815,14,21,18,15,212,105,4,321
140211816,14,21,18,16,162,127,8,297
140211901,14,21,19,1,144,77,7,228
140211902,14,21,19,2,146,97,20,263
140211903,14,21,19,3,130,35,3,168
140211904,14,21,19,4,133,26,0,159
140211905,14,21,19,5,153,35,0,188
140211906,14,21,19,6,151,45,0,196
140211907,14,21,19,7,111,48,5,164
140211908,14,21,19,8,90,51,10,151
140211909,14,21,19,9,176,60,3,239
140211910,14,21,19,10,171,124,5,300
140211911,14,21,19,11,141,130,8,279
140211912,14,21,19,12,150,45,5,200
140211913,14,21,19,13,108,95,4,207
140212001,14,21,20,1,26,71,72,169
140212002,14,21,20,2,47,73,50,170
140212003,14,21,20,3,103,142,57,302
140212004,14,21,20,4,57,120,54,231
140212005,14,21,20,5,64,154,80,298
140212006,14,21,20,6,46,117,25,188
140212007,14,21,20,7,57,140,82,279
140212008,14,21,20,8,59,110,54,223
140212009,14,21,20,9,61,106,29,196
140212010,14,21,20,10,84,88,26,198
140212011,14,21,20,11,159,25,0,184
140212012,14,21,20,12,154,79,2,235
140212013,14,21,20,13,163,70,3,236
140212014,14,21,20,14,147,165,8,320
140212015,14,21,20,15,199,96,1,296
140212016,14,21,20,16,117,58,8,183
140212017,14,21,20,17,78,87,17,182
140212018,14,21,20,18,47,132,85,264
140212101,14,21,21,1,180,74,2,256
140212102,14,21,21,2,75,52,43,170
140212103,14,21,21,3,52,82,42,176
140212104,14,21,21,4,22,13,17,52
140212105,14,21,21,5,108,74,57,239
140212106,14,21,21,6,107,134,24,265
140212107,14,21,21,7,127,76,5,208
140212108,14,21,21,8,110,87,5,202
140212109,14,21,21,9,81,104,4,189
140212110,14,21,21,10,91,127,76,294
140212111,14,21,21,11,33,38,19,90
140212112,14,21,21,12,37,50,65,152
140212113,14,21,21,13,57,140,63,260
140212114,14,21,21,14,58,102,26,186
140212115,14,21,21,15,78,86,7,171
140212116,14,21,21,16,167,97,5,269
140212117,14,21,21,17,79,60,6,145
140212118,14,21,21,18,134,188,30,352
140212119,14,21,21,19,122,49,0,171
140212120,14,21,21,20,151,36,0,187
140280101,14,28,1,1,0,0,24,24
140280102,14,28,1,2,5,12,122,139
140280103,14,28,1,3,22,9,61,92
140280104,14,28,1,4,14,50,171,235
140280105,14,28,1,5,8,21,132,161
140280106,14,28,1,6,11,14,44,69
140280107,14,28,1,7,9,11,6,26
140280108,14,28,1,8,9,9,83,101
140280109,14,28,1,9,29,56,108,193
140280110,14,28,1,10,39,63,237,339
140280111,14,28,1,11,63,89,101,253
140280201,14,28,2,1,75,66,225,366
140280202,14,28,2,2,60,111,87,258
140280203,14,28,2,3,89,84,83,256
140280204,14,28,2,4,103,191,144,438
140280205,14,28,2,5,69,99,45,213
140280206,14,28,2,6,110,83,2,195
140280207,14,28,2,7,138,70,9,217
140280208,14,28,2,8,129,112,74,315
140280209,14,28,2,9,163,121,8,292
140280210,14,28,2,10,76,119,29,224
140280211,14,28,2,11,220,97,32,349
140280212,14,28,2,12,229,70,19,318
140280213,14,28,2,13,104,139,61,304
140280214,14,28,2,14,171,129,6,306
140280215,14,28,2,15,211,121,21,353
140280216,14,28,2,16,199,126,39,364
140280301,14,28,3,1,42,99,117,258
140280302,14,28,3,2,102,148,61,311
140280303,14,28,3,3,153,126,32,311
140280304,14,28,3,4,225,94,23,342
140280305,14,28,3,5,162,107,44,313
140280306,14,28,3,6,171,59,3,233
140280307,14,28,3,7,160,80,5,245
140280308,14,28,3,8,114,105,5,224
140280309,14,28,3,9,221,57,9,287
140280310,14,28,3,10,145,111,24,280
140280311,14,28,3,11,116,87,84,287
140280312,14,28,3,12,17,67,65,149
140280401,14,28,4,1,1,0,23,24
140280402,14,28,4,2,11,6,82,99
140280403,14,28,4,3,4,5,101,110
140280404,14,28,4,4,5,16,96,117
140280405,14,28,4,5,1,7,69,77
140280406,14,28,4,6,54,40,97,191
140280407,14,28,4,7,66,55,88,209
140280408,14,28,4,8,74,49,82,205
140280409,14,28,4,9,56,92,116,264
140280410,14,28,4,10,50,50,114,214
140280501,14,28,5,1,35,34,80,149
140280502,14,28,5,2,29,18,87,134
140280503,14,28,5,3,4,10,32,46
140280504,14,28,5,4,16,23,74,113
140280505,14,28,5,5,60,113,69,242
140280506,14,28,5,6,99,132,49,280
140280507,14,28,5,7,106,99,59,264
140280508,14,28,5,8,87,122,47,256
140280509,14,28,5,9,104,104,11,219
140280510,14,28,5,10,145,62,18,225
140280511,14,28,5,11,89,75,45,209
140280512,14,28,5,12,100,71,39,210
140280513,14,28,5,13,101,76,31,208
140280514,14,28,5,14,240,137,11,388
140280515,14,28,5,15,44,44,22,110
140280601,14,28,6,1,4,7,10,21
140280602,14,28,6,2,31,34,30,95
140280603,14,28,6,3,45,51,48,144
140280604,14,28,6,4,2,38,15,55
140280605,14,28,6,5,5,4,10,19
140280606,14,28,6,6,99,60,34,193
140280607,14,28,6,7,165,83,30,278
140280701,14,28,7,1,4,19,32,55
140280702,14,28,7,2,2,16,39,57
140280703,14,28,7,3,2,4,26,32
140280704,14,28,7,4,2,4,7,13
140280705,14,28,7,5,1,8,14,23
140280706,14,28,7,6,4,22,51,77
140350101,14,35,1,1,17,1,1,19
140350102,14,35,1,2,5,6,3,14
140350103,14,35,1,3,26,12,12,50
140350104,14,35,1,4,14,11,6,31
140350105,14,35,1,5,16,4,4,24
140350106,14,35,1,6,25,9,12,46
140350107,14,35,1,7,28,15,76,119
140350108,14,35,1,8,138,67,152,357
140350109,14,35,1,9,180,88,27,295
140350110,14,35,1,10,104,74,36,214
140350201,14,35,2,1,14,8,1,23
140350202,14,35,2,2,19,12,3,34
140350203,14,35,2,3,11,5,4,20
140350204,14,35,2,4,5,11,2,18
140350205,14,35,2,5,13,2,4,19
140350206,14,35,2,6,47,23,33,103
140350207,14,35,2,7,14,6,2,22
140350208,14,35,2,8,14,12,9,35
140350209,14,35,2,9,11,8,3,22
140350210,14,35,2,10,27,44,128,199
140350211,14,35,2,11,37,64,103,204
140350212,14,35,2,12,220,129,10,359
140350213,14,35,2,13,198,120,16,334
140350214,14,35,2,14,186,77,14,277
140350215,14,35,2,15,183,85,39,307
140350301,14,35,3,1,20,10,8,38
140350302,14,35,3,2,10,3,5,18
140350303,14,35,3,3,44,30,10,84
140350304,14,35,3,4,35,28,9,72
140350305,14,35,3,5,42,22,11,75
140350306,14,35,3,6,36,17,13,66
140350307,14,35,3,7,105,46,32,183
140350308,14,35,3,8,23,13,6,42
140350309,14,35,3,9,25,11,11,47
140350310,14,35,3,10,83,53,23,159
140350311,14,35,3,11,169,107,14,290
140350312,14,35,3,12,237,30,12,279
140350313,14,35,3,13,136,94,17,247
140350314,14,35,3,14,106,118,3,227
140350315,14,35,3,15,182,102,9,293
140350316,14,35,3,16,175,62,29,266
140350317,14,35,3,17,185,151,30,366
140350318,14,35,3,18,257,84,17,358
140350401,14,35,4,1,18,8,2,28
140350402,14,35,4,2,33,15,9,57
140350403,14,35,4,3,49,17,7,73
140350404,14,35,4,4,103,48,64,215
140350405,14,35,4,5,124,71,50,245
140350406,14,35,4,6,269,30,38,337
140350407,14,35,4,7,227,29,7,263
140350408,14,35,4,8,175,13,2,190
140350409,14,35,4,9,192,35,8,235
140350410,14,35,4,10,193,8,1,202
140350411,14,35,4,11,155,12,18,185
140350412,14,35,4,12,193,34,31,258
140350413,14,35,4,13,198,25,23,246
140350414,14,35,4,14,106,94,89,289
140350415,14,35,4,15,206,59,23,288
140350501,14,35,5,1,8,3,2,13
140350502,14,35,5,2,17,14,15,46
140350503,14,35,5,3,14,11,8,33
140350504,14,35,5,4,21,18,8,47
140350505,14,35,5,5,22,11,5,38
140350506,14,35,5,6,22,8,5,35
140350507,14,35,5,7,8,6,2,16
140350508,14,35,5,8,119,59,51,229
140350509,14,35,5,9,94,48,64,206
140350510,14,35,5,10,109,45,66,220
140350511,14,35,5,11,222,18,13,253
140350512,14,35,5,12,198,96,75,369
140350513,14,35,5,13,211,35,34,280
140350514,14,35,5,14,104,61,24,189
140420101,14,42,1,1,17,20,4,41
140420102,14,42,1,2,11,14,5,30
140420103,14,42,1,3,12,38,7,57
140420104,14,42,1,4,18,15,3,36
140420105,14,42,1,5,26,41,22,89
140420106,14,42,1,6,16,14,9,39
140420107,14,42,1,7,35,18,10,63
140420108,14,42,1,8,15,36,31,82
140420109,14,42,1,9,147,168,25,340
140420110,14,42,1,10,133,89,5,227
140420111,14,42,1,11,108,147,14,269
140420112,14,42,1,12,29,102,2,133
140420201,14,42,2,1,10,20,5,35
140420202,14,42,2,2,22,35,5,62
140420203,14,42,2,3,10,32,4,46
140420204,14,42,2,4,15,9,5,29
140420205,14,42,2,5,26,45,15,86
140420206,14,42,2,6,13,6,10,29
140420207,14,42,2,7,19,15,9,43
140420208,14,42,2,8,29,80,17,126
140420209,14,42,2,9,54,16,46,116
140420210,14,42,2,10,69,116,35,220
140420301,14,42,3,1,18,55,20,93
140420302,14,42,3,2,16,55,8,79
140420303,14,42,3,3,26,25,6,57
140420304,14,42,3,4,20,24,8,52
140420305,14,42,3,5,35,9,11,55
140420306,14,42,3,6,2,8,0,10
140420307,14,42,3,7,68,55,11,134
140420308,14,42,3,8,58,68,25,151
140420309,14,42,3,9,113,132,12,257
140420310,14,42,3,10,109,161,53,323
140420311,14,42,3,11,167,95,3,265
140420312,14,42,3,12,74,43,3,120
140420313,14,42,3,13,300,116,2,418
140420314,14,42,3,14,251,134,5,390
140420401,14,42,4,1,147,155,10,312
140420402,14,42,4,2,164,53,15,232
140420403,14,42,4,3,96,108,24,228
140420404,14,42,4,4,186,189,5,380
140420405,14,42,4,5,186,159,10,355
140420406,14,42,4,6,132,182,6,320
140420407,14,42,4,7,162,137,22,321
140420408,14,42,4,8,145,143,21,309
140420409,14,42,4,9,98,139,17,254
140420410,14,42,4,10,95,171,13,279
140420411,14,42,4,11,184,123,26,333
140420412,14,42,4,12,106,140,29,275
140420413,14,42,4,13,121,137,74,332
140420414,14,42,4,14,89,102,28,219
140420415,14,42,4,15,157,144,69,370
140420416,14,42,4,16,82,91,21,194
140420417,14,42,4,17,108,87,16,211
140420418,14,42,4,18,149,111,23,283
140420419,14,42,4,19,104,69,19,192
140420501,14,42,5,1,10,11,2,23
140420502,14,42,5,2,13,9,2,24
140420503,14,42,5,3,14,7,1,22
140420504,14,42,5,4,13,18,7,38
140420505,14,42,5,5,15,11,2,28
140420506,14,42,5,6,11,16,2,29
140420507,14,42,5,7,6,28,6,40
140420508,14,42,5,8,19,39,17,75
140420509,14,42,5,9,13,35,6,54
140420510,14,42,5,10,62,89,21,172
140420511,14,42,5,11,99,62,10,171
140420512,14,42,5,12,119,73,28,220
140420513,14,42,5,13,130,55,17,202
140420514,14,42,5,14,165,92,2,259
140420515,14,42,5,15,102,76,4,182
140420516,14,42,5,16,91,97,7,195
140420517,14,42,5,17,190,109,16,315
140420601,14,42,6,1,43,100,105,248
140420602,14,42,6,2,57,146,27,230
140420603,14,42,6,3,187,98,46,331
140420604,14,42,6,4,166,141,1,308
140420605,14,42,6,5,119,144,11,274
140420606,14,42,6,6,164,163,2,329
140420607,14,42,6,7,123,91,3,217
140420608,14,42,6,8,174,235,12,421
140420609,14,42,6,9,78,194,3,275
140420610,14,42,6,10,122,77,5,204
140420611,14,42,6,11,192,101,1,294
140420612,14,42,6,12,104,70,0,174
140420613,14,42,6,13,191,107,1,299
140420614,14,42,6,14,174,106,1,281
140420615,14,42,6,15,78,124,105,307
140420616,14,42,6,16,196,165,18,379
140420617,14,42,6,17,145,134,2,281
140420618,14,42,6,18,59,115,28,202
140420619,14,42,6,19,118,50,2,170
140420620,14,42,6,20,116,59,0,175
140420621,14,42,6,21,216,180,2,398
140420701,14,42,7,1,45,175,116,336
140420702,14,42,7,2,63,172,80,315
140420703,14,42,7,3,116,173,106,395
140420704,14,42,7,4,210,48,29,287
140420705,14,42,7,5,173,197,1,371
140420706,14,42,7,6,140,105,1,246
140420707,14,42,7,7,197,111,1,309
140420708,14,42,7,8,186,113,6,305
140420709,14,42,7,9,192,66,48,306
140420710,14,42,7,10,87,142,96,325
140420711,14,42,7,11,93,399,66,558
140420712,14,42,7,12,65,155,33,253
140420713,14,42,7,13,131,107,5,243
140420714,14,42,7,14,91,75,0,166
140420715,14,42,7,15,106,170,30,306
140420801,14,42,8,1,145,72,3,220
140420802,14,42,8,2,118,37,0,155
140420803,14,42,8,3,193,126,2,321
140420804,14,42,8,4,88,84,0,172
140420805,14,42,8,5,180,112,1,293
140420806,14,42,8,6,136,90,1,227
140420807,14,42,8,7,179,97,3,279
140420808,14,42,8,8,93,115,2,210
140420809,14,42,8,9,225,53,1,279
140420810,14,42,8,10,99,213,6,318
140420811,14,42,8,11,105,106,3,214
140420812,14,42,8,12,199,123,1,323
140420813,14,42,8,13,131,41,3,175
140420814,14,42,8,14,154,93,3,250
140420815,14,42,8,15,80,133,65,278
140420816,14,42,8,16,78,63,133,274
140420817,14,42,8,17,109,75,3,187
140420818,14,42,8,18,155,118,1,274
140420819,14,42,8,19,161,184,54,399
140420820,14,42,8,20,182,20,0,202
140420821,14,42,8,21,124,59,0,183
140420822,14,42,8,22,63,125,3,191
140420823,14,42,8,23,89,137,7,233
140420901,14,42,9,1,99,91,46,236
140420902,14,42,9,2,151,130,18,299
140420903,14,42,9,3,108,132,9,249
140420904,14,42,9,4,79,102,40,221
140420905,14,42,9,5,207,86,16,309
140420906,14,42,9,6,88,156,69,313
140420907,14,42,9,7,125,73,2,200
140420908,14,42,9,8,154,49,2,205
140420909,14,42,9,9,159,203,7,369
140420910,14,42,9,10,96,92,18,206
140420911,14,42,9,11,83,97,0,180
140420912,14,42,9,12,44,75,0,119
140420913,14,42,9,13,161,78,2,241
140420914,14,42,9,14,169,142,4,315
140420915,14,42,9,15,150,95,2,247
140420916,14,42,9,16,160,104,0,264
140420917,14,42,9,17,174,64,6,244
140420918,14,42,9,18,110,117,3,230
140420919,14,42,9,19,195,85,6,286
140420920,14,42,9,20,119,105,28,252
140420921,14,42,9,21,101,124,26,251
140420922,14,42,9,22,48,147,0,195
140420923,14,42,9,23,96,92,1,189
140420924,14,42,9,24,126,84,1,211
140420925,14,42,9,25,134,80,0,214
140421001,14,42,10,1,20,17,12,49
140421002,14,42,10,2,10,24,10,44
140421003,14,42,10,3,1,2,0,3
140421004,14,42,10,4,9,9,8,26
140421005,14,42,10,5,13,13,13,39
140421006,14,42,10,6,8,15,2,25
140421007,14,42,10,7,9,18,0,27
140421008,14,42,10,8,124,85,13,222
140421009,14,42,10,9,146,95,30,271
140421010,14,42,10,10,92,92,44,228
140421011,14,42,10,11,69,76,20,165
140421012,14,42,10,12,183,79,12,274
140421013,14,42,10,13,75,129,10,214
140421014,14,42,10,14,162,43,7,212
140421015,14,42,10,15,184,81,4,269
140421016,14,42,10,16,193,119,30,342
140421101,14,42,11,1,79,134,12,225
140421102,14,42,11,2,135,87,0,222
140421103,14,42,11,3,113,123,1,237
140421104,14,42,11,4,95,150,3,248
140421105,14,42,11,5,177,121,19,317
140421106,14,42,11,6,52,124,33,209
140421107,14,42,11,7,109,168,139,416
140421108,14,42,11,8,137,136,107,380
140421109,14,42,11,9,161,147,48,356
140421110,14,42,11,10,167,103,6,276
140421111,14,42,11,11,110,167,13,290
140421112,14,42,11,12,96,194,0,290
140421113,14,42,11,13,83,103,9,195
140490101,14,49,1,1,3,24,12,39
140490102,14,49,1,2,2,15,29,46
140490103,14,49,1,3,9,12,40,61
140490104,14,49,1,4,2,9,26,37
140490105,14,49,1,5,4,1,44,49
140490106,14,49,1,6,1,3,19,23
140490107,14,49,1,7,2,5,17,24
140490108,14,49,1,8,12,23,23,58
140490109,14,49,1,9,13,24,68,105
140490110,14,49,1,10,6,6,6,18
140490111,14,49,1,11,45,48,26,119
140490112,14,49,1,12,27,62,32,121
140490113,14,49,1,13,119,96,87,302
140490114,14,49,1,14,90,100,33,223
140490115,14,49,1,15,36,103,40,179
140490116,14,49,1,16,46,123,167,336
140490201,14,49,2,1,49,25,122,196
140490202,14,49,2,2,0,15,30,45
140490203,14,49,2,3,6,10,18,34
140490204,14,49,2,4,12,24,45,81
140490205,14,49,2,5,1,17,6,24
140490206,14,49,2,6,5,12,9,26
140490207,14,49,2,7,6,8,37,51
140490208,14,49,2,8,4,3,2,9
140490209,14,49,2,9,5,10,10,25
140490210,14,49,2,10,8,20,21,49
140490211,14,49,2,11,34,47,45,126
140490212,14,49,2,12,1,21,6,28
140490213,14,49,2,13,14,29,23,66
140490214,14,49,2,14,13,28,100,141
140490215,14,49,2,15,22,39,22,83
140490301,14,49,3,1,19,76,66,161
140490302,14,49,3,2,61,48,58,167
140490303,14,49,3,3,190,87,20,297
140490304,14,49,3,4,95,39,25,159
140490305,14,49,3,5,95,96,25,216
140490306,14,49,3,6,69,73,16,158
140490307,14,49,3,7,167,92,0,259
140490308,14,49,3,8,121,91,12,224
140490309,14,49,3,9,198,97,6,301
140490310,14,49,3,10,171,53,2,226
140490311,14,49,3,11,227,56,36,319
140490312,14,49,3,12,107,90,60,257
140490313,14,49,3,13,132,67,17,216
140490314,14,49,3,14,69,81,40,190
140490315,14,49,3,15,82,37,1,120
140490316,14,49,3,16,122,73,13,208
140490317,14,49,3,17,127,50,13,190
140490318,14,49,3,18,159,54,5,218
140490319,14,49,3,19,224,106,19,349
140490320,14,49,3,20,125,145,15,285
140490321,14,49,3,21,85,98,25,208
140490322,14,49,3,22,146,133,30,309
140490323,14,49,3,23,69,95,43,207
140490324,14,49,3,24,54,57,47,158
140490325,14,49,3,25,127,99,37,263
140560101,14,56,1,1,23,30,15,68
140560102,14,56,1,2,23,36,5,64
140560103,14,56,1,3,22,26,8,56
140560104,14,56,1,4,181,171,16,368
140560105,14,56,1,5,152,206,27,385
140560106,14,56,1,6,157,171,19,347
140560107,14,56,1,7,146,132,3,281
140560108,14,56,1,8,126,167,32,325
140560109,14,56,1,9,43,145,64,252
140560110,14,56,1,10,101,136,30,267
140560111,14,56,1,11,115,98,21,234
140560112,14,56,1,12,126,101,7,234
140560113,14,56,1,13,162,136,5,303
140560114,14,56,1,14,121,97,3,221
140560115,14,56,1,15,139,50,2,191
140560116,14,56,1,16,121,109,2,232
140560117,14,56,1,17,186,144,20,350
140560118,14,56,1,18,129,109,7,245
140560201,14,56,2,1,19,12,5,36
140560202,14,56,2,2,10,9,1,20
140560203,14,56,2,3,1,8,0,9
140560204,14,56,2,4,108,94,4,206
140560205,14,56,2,5,151,140,8,299
140560206,14,56,2,6,171,124,5,300
140560207,14,56,2,7,84,66,0,150
140560208,14,56,2,8,169,58,1,228
140560209,14,56,2,9,106,128,14,248
140560210,14,56,2,10,202,124,2,328
140560211,14,56,2,11,225,120,13,358
140560212,14,56,2,12,108,218,16,342
140560213,14,56,2,13,243,212,6,461
140560214,14,56,2,14,192,212,34,438
140560301,14,56,3,1,1,5,0,6
140560302,14,56,3,2,12,12,7,31
140560303,14,56,3,3,23,34,4,61
140560304,14,56,3,4,21,27,8,56
140560305,14,56,3,5,10,28,0,38
140560306,14,56,3,6,8,3,1,12
140560307,14,56,3,7,4,7,0,11
140560308,14,56,3,8,10,17,0,27
140560309,14,56,3,9,20,18,1,39
140560310,14,56,3,10,20,26,1,47
140560311,14,56,3,11,177,110,13,300
140560312,14,56,3,12,130,152,6,288
140560313,14,56,3,13,255,92,4,351
140560314,14,56,3,14,172,62,23,257
140560315,14,56,3,15,112,84,2,198
140560316,14,56,3,16,68,180,35,283
140560317,14,56,3,17,68,104,11,183
140560318,14,56,3,18,72,95,18,185
140560319,14,56,3,19,137,195,19,351
140560320,14,56,3,20,119,83,7,209
140560401,14,56,4,1,23,11,0,34
140560402,14,56,4,2,15,28,3,46
140560403,14,56,4,3,5,4,2,11
140560404,14,56,4,4,5,4,1,10
140560405,14,56,4,5,17,13,6,36
140560406,14,56,4,6,4,14,6,24
140560407,14,56,4,7,173,133,54,360
140560408,14,56,4,8,39,90,14,143
140560409,14,56,4,9,88,112,10,210
140560410,14,56,4,10,82,86,30,198
140560411,14,56,4,11,137,79,7,223
140560412,14,56,4,12,117,50,22,189
140560413,14,56,4,13,146,119,23,288
140560414,14,56,4,14,183,90,10,283
140560415,14,56,4,15,162,99,6,267
140560501,14,56,5,1,16,10,0,26
140560502,14,56,5,2,7,10,4,21
140560503,14,56,5,3,15,1,0,16
140560504,14,56,5,4,18,20,9,47
140560505,14,56,5,5,2,8,0,10
140560506,14,56,5,6,25,31,6,62
140560507,14,56,5,7,19,25,14,58
140560508,14,56,5,8,80,111,12,203
140560509,14,56,5,9,75,109,14,198
140560601,14,56,6,1,27,31,4,62
140560602,14,56,6,2,21,12,4,37
140560603,14,56,6,3,9,12,0,21
140560604,14,56,6,4,10,9,0,19
140560605,14,56,6,5,16,9,5,30
140560606,14,56,6,6,15,8,1,24
140560607,14,56,6,7,14,10,4,28
140560608,14,56,6,8,22,27,2,51
140560609,14,56,6,9,37,32,12,81
140560610,14,56,6,10,27,10,5,42
140560611,14,56,6,11,22,27,8,57
140560612,14,56,6,12,24,26,17,67
140560613,14,56,6,13,20,35,16,71
140560614,14,56,6,14,12,9,1,22
140560615,14,56,6,15,106,107,44,257
140560616,14,56,6,16,164,55,8,227
140560617,14,56,6,17,147,110,13,270
140560618,14,56,6,18,96,57,27,180
140560701,14,56,7,1,157,64,7,228
140560702,14,56,7,2,143,60,14,217
140560703,14,56,7,3,179,89,18,286
140560704,14,56,7,4,165,65,11,241
140560705,14,56,7,5,123,63,11,197
140560706,14,56,7,6,174,121,24,319
140560707,14,56,7,7,106,101,2,209
140560708,14,56,7,8,241,102,3,346
140560709,14,56,7,9,249,116,27,392
140560710,14,56,7,10,129,89,6,224
140560711,14,56,7,11,206,127,11,344
140560712,14,56,7,12,162,169,57,388
140560713,14,56,7,13,72,154,78,304
140560714,14,56,7,14,201,19,8,228
140630101,14,63,1,1,9,13,7,29
140630102,14,63,1,2,16,12,1,29
140630103,14,63,1,3,14,6,1,21
140630104,14,63,1,4,5,6,1,12
140630105,14,63,1,5,7,9,2,18
140630106,14,63,1,6,8,25,3,36
140630107,14,63,1,7,14,2,1,17
140630108,14,63,1,8,9,10,0,19
140630109,14,63,1,9,130,133,14,277
140630201,14,63,2,1,17,6,6,29
140630202,14,63,2,2,28,32,10,70
140630203,14,63,2,3,14,14,1,29
140630204,14,63,2,4,13,14,3,30
140630205,14,63,2,5,9,5,2,16
140630206,14,63,2,6,17,14,1,32
140630207,14,63,2,7,17,9,1,27
140630208,14,63,2,8,14,16,3,33
140630209,14,63,2,9,15,7,2,24
140630210,14,63,2,10,18,17,2,37
140630211,14,63,2,11,21,6,1,28
140630212,14,63,2,12,195,131,4,330
140630213,14,63,2,13,135,113,15,263
140630214,14,63,2,14,127,68,7,202
140630215,14,63,2,15,41,85,15,141
140630301,14,63,3,1,7,4,2,13
140630302,14,63,3,2,23,8,6,37
140630303,14,63,3,3,36,53,17,106
140630304,14,63,3,4,107,116,18,241
140630305,14,63,3,5,160,104,5,269
140630306,14,63,3,6,165,136,8,309
140630307,14,63,3,7,151,75,2,228
140630308,14,63,3,8,123,120,8,251
140630309,14,63,3,9,131,60,4,195
140630310,14,63,3,10,150,57,4,211
140630311,14,63,3,11,147,108,25,280
140630401,14,63,4,1,9,2,1,12
140630402,14,63,4,2,10,13,0,23
140630403,14,63,4,3,3,9,1,13
140630404,14,63,4,4,17,3,3,23
140630405,14,63,4,5,20,9,1,30
140630406,14,63,4,6,9,0,0,9
140630407,14,63,4,7,153,133,32,318
140630408,14,63,4,8,137,117,7,261
140630409,14,63,4,9,100,69,17,186
140630410,14,63,4,10,111,81,4,196
140630411,14,63,4,11,134,55,2,191
140630412,14,63,4,12,88,73,2,163
140630413,14,63,4,13,163,133,17,313
140630414,14,63,4,14,136,108,1,245
140630415,14,63,4,15,108,91,11,210
140630501,14,63,5,1,26,33,5,64
140630502,14,63,5,2,33,19,0,52
140630503,14,63,5,3,16,10,1,27
140630504,14,63,5,4,102,70,9,181
140630505,14,63,5,5,150,128,1,279
140630506,14,63,5,6,160,106,6,272
140630507,14,63,5,7,129,94,4,227
140630508,14,63,5,8,194,77,8,279
140630509,14,63,5,9,123,60,6,189
140630510,14,63,5,10,165,122,40,327
140630511,14,63,5,11,76,122,17,215
140630512,14,63,5,12,133,46,7,186
140630513,14,63,5,13,181,105,0,286
140630514,14,63,5,14,191,64,3,258
140630515,14,63,5,15,200,122,8,330
140630516,14,63,5,16,181,104,8,293
140630517,14,63,5,17,49,69,11,129
140630601,14,63,6,1,3,2,0,5
140630602,14,63,6,2,3,1,0,4
140630603,14,63,6,3,22,19,2,43
140630604,14,63,6,4,24,8,6,38
140630605,14,63,6,5,15,0,3,18
140630606,14,63,6,6,19,12,0,31
140630607,14,63,6,7,148,123,13,284
140630608,14,63,6,8,124,91,2,217
140630609,14,63,6,9,113,139,41,293
140630610,14,63,6,10,141,105,2,248
140630611,14,63,6,11,134,145,8,287
140630612,14,63,6,12,163,59,5,227
140630613,14,63,6,13,121,152,18,291
140630614,14,63,6,14,32,16,12,60
140630615,14,63,6,15,115,122,12,249
140630701,14,63,7,1,26,38,33,97
140630702,14,63,7,2,20,25,4,49
140630703,14,63,7,3,19,15,0,34
140630704,14,63,7,4,21,6,1,28
140630705,14,63,7,5,30,8,1,39
140630706,14,63,7,6,124,137,16,277
140630707,14,63,7,7,145,81,19,245
140630708,14,63,7,8,203,102,4,309
140630709,14,63,7,9,184,116,7,307
140630710,14,63,7,10,32,32,39,103
140630711,14,63,7,11,39,90,50,179
140630801,14,63,8,1,17,5,2,24
140630802,14,63,8,2,18,10,3,31
140630803,14,63,8,3,24,14,6,44
140630804,14,63,8,4,37,17,1,55
140630805,14,63,8,5,15,3,2,20
140630806,14,63,8,6,9,11,0,20
140630807,14,63,8,7,49,64,34,147
140630808,14,63,8,8,159,81,8,248
140630809,14,63,8,9,155,61,1,217
140630810,14,63,8,10,164,62,12,238
140630811,14,63,8,11,107,72,20,199
140630812,14,63,8,12,103,63,38,204
140630901,14,63,9,1,11,8,2,21
140630902,14,63,9,2,24,11,1,36
140630903,14,63,9,3,33,30,9,72
140630904,14,63,9,4,37,23,4,64
140630905,14,63,9,5,24,6,0,30
140630906,14,63,9,6,9,11,0,20
140630907,14,63,9,7,22,7,3,32
140630908,14,63,9,8,5,30,2,37
140630909,14,63,9,9,31,20,5,56
140630910,14,63,9,10,104,71,13,188
140630911,14,63,9,11,135,46,4,185
140630912,14,63,9,12,168,46,10,224
140630913,14,63,9,13,73,44,64,181
140630914,14,63,9,14,134,92,56,282
140630915,14,63,9,15,222,87,15,324
140630916,14,63,9,16,175,107,7,289
140630917,14,63,9,17,68,42,15,125
140630918,14,63,9,18,171,98,4,273
140630919,14,63,9,19,173,41,0,214
140630920,14,63,9,20,164,89,15,268
140630921,14,63,9,21,155,98,32,285
140630922,14,63,9,22,136,131,84,351
140630923,14,63,9,23,89,79,11,179
140631001,14,63,10,1,58,42,44,144
140631002,14,63,10,2,113,175,15,303
140631003,14,63,10,3,194,153,1,348
140631004,14,63,10,4,109,118,0,227
140631005,14,63,10,5,78,114,1,193
140631006,14,63,10,6,131,118,1,250
140631007,14,63,10,7,111,229,11,351
140631008,14,63,10,8,142,72,19,233
140631009,14,63,10,9,140,110,5,255
140631010,14,63,10,10,114,100,4,218
140631011,14,63,10,11,146,87,0,233
140631012,14,63,10,12,107,217,14,338
140631013,14,63,10,13,134,196,39,369
140631101,14,63,11,1,174,161,21,356
140631102,14,63,11,2,123,133,17,273
140631103,14,63,11,3,115,87,11,213
140631104,14,63,11,4,119,80,46,245
140631105,14,63,11,5,232,123,10,365
140631106,14,63,11,6,111,83,4,198
140631107,14,63,11,7,171,75,1,247
140631108,14,63,11,8,126,82,13,221
140631109,14,63,11,9,134,53,6,193
140631110,14,63,11,10,174,156,9,339
140631111,14,63,11,11,124,115,3,242
140631112,14,63,11,12,108,45,0,153
140631113,14,63,11,13,194,53,0,247
140631114,14,63,11,14,134,102,1,237
140631115,14,63,11,15,129,76,1,206
140631116,14,63,11,16,189,172,6,367
140631201,14,63,12,1,105,109,10,224
140631202,14,63,12,2,120,86,0,206
140631203,14,63,12,3,150,103,1,254
140631204,14,63,12,4,129,39,2,170
140631205,14,63,12,5,204,141,6,351
140631206,14,63,12,6,192,97,13,302
140631207,14,63,12,7,185,78,9,272
140631208,14,63,12,8,142,110,0,252
140631209,14,63,12,9,139,172,20,331
140631210,14,63,12,10,95,176,54,325
140631211,14,63,12,11,99,154,22,275
140631212,14,63,12,12,136,139,13,288
140631213,14,63,12,13,108,148,3,259
140631214,14,63,12,14,183,120,12,315
140631215,14,63,12,15,79,170,42,291
140631216,14,63,12,16,124,142,19,285
140631301,14,63,13,1,110,151,69,330
140631302,14,63,13,2,63,67,56,186
140631303,14,63,13,3,202,105,21,328
140631304,14,63,13,4,158,73,9,240
140631305,14,63,13,5,208,191,16,415
140631306,14,63,13,6,217,55,3,275
140631307,14,63,13,7,130,45,1,176
140631308,14,63,13,8,181,83,0,264
140631309,14,63,13,9,197,131,7,335
140631310,14,63,13,10,107,45,4,156
140631311,14,63,13,11,162,64,6,232
140631312,14,63,13,12,142,55,5,202
140631313,14,63,13,13,126,52,13,191
140631314,14,63,13,14,204,83,2,289
140700101,14,70,1,1,5,7,62,74
140700102,14,70,1,2,2,3,30,35
140700103,14,70,1,3,18,27,50,95
140700104,14,70,1,4,1,5,30,36
140700105,14,70,1,5,3,22,81,106
140700201,14,70,2,1,3,7,33,43
140700202,14,70,2,2,0,4,33,37
140700203,14,70,2,3,2,11,78,91
140700204,14,70,2,4,0,2,27,29
140700205,14,70,2,5,8,7,65,80
140700206,14,70,2,6,4,25,63,92
140700207,14,70,2,7,18,28,17,63
140700208,14,70,2,8,2,3,31,36
140700209,14,70,2,9,2,12,31,45
140700210,14,70,2,10,6,22,58,86
140700211,14,70,2,11,40,28,20,88
140700212,14,70,2,12,79,50,6,135
140700213,14,70,2,13,163,95,18,276
140770101,14,77,1,1,1,0,12,13
140770102,14,77,1,2,0,0,8,8
140770103,14,77,1,3,0,1,42,43
140770104,14,77,1,4,1,1,19,21
140770105,14,77,1,5,0,2,43,45
140770106,14,77,1,6,1,0,45,46
140770107,14,77,1,7,2,1,40,43
140770108,14,77,1,8,0,11,15,26
140770109,14,77,1,9,0,0,30,30
140770110,14,77,1,10,16,39,54,109
140770201,14,77,2,1,3,17,30,50
140770202,14,77,2,2,18,26,39,83
140770203,14,77,2,3,11,21,88,120
140770204,14,77,2,4,7,56,120,183
140770205,14,77,2,5,10,20,25,55
140770206,14,77,2,6,1,7,10,18
140770207,14,77,2,7,3,19,28,50
140770208,14,77,2,8,2,13,40,55
140770209,14,77,2,9,2,11,21,34
140770210,14,77,2,10,93,118,14,225
140770211,14,77,2,11,113,69,12,194
140770212,14,77,2,12,8,28,19,55
140770213,14,77,2,13,18,17,22,57
140840101,14,84,1,1,29,14,7,50
140840102,14,84,1,2,29,16,4,49
140840103,14,84,1,3,10,28,11,49
140840104,14,84,1,4,11,8,0,19
140840105,14,84,1,5,8,7,6,21
140840106,14,84,1,6,192,128,30,350
140840107,14,84,1,7,183,77,4,264
140840108,14,84,1,8,222,140,17,379
140840109,14,84,1,9,140,110,37,287
140840110,14,84,1,10,152,81,30,263
140840111,14,84,1,11,130,117,44,291
140840201,14,84,2,1,9,9,6,24
140840202,14,84,2,2,16,3,8,27
140840203,14,84,2,3,9,9,6,24
140840204,14,84,2,4,17,13,16,46
140840205,14,84,2,5,10,7,11,28
140840206,14,84,2,6,19,16,20,55
140840207,14,84,2,7,19,15,11,45
140840208,14,84,2,8,10,21,6,37
140840209,14,84,2,9,67,38,17,122
140840210,14,84,2,10,143,119,14,276
140840301,14,84,3,1,9,21,1,31
140840302,14,84,3,2,22,26,0,48
140840303,14,84,3,3,7,13,7,27
140840304,14,84,3,4,11,11,4,26
140840305,14,84,3,5,22,18,2,42
140840306,14,84,3,6,10,10,2,22
140840307,14,84,3,7,8,1,16,25
140840308,14,84,3,8,14,6,8,28
140840309,14,84,3,9,11,10,8,29
140840310,14,84,3,10,7,2,13,22
140840311,14,84,3,11,9,7,2,18
140840312,14,84,3,12,18,13,2,33
140840313,14,84,3,13,105,80,24,209
140840314,14,84,3,14,108,93,21,222
140840315,14,84,3,15,65,29,79,173
140840316,14,84,3,16,75,64,16,155
140840401,14,84,4,1,17,14,10,41
140840402,14,84,4,2,21,20,13,54
140840403,14,84,4,3,10,4,0,14
140840404,14,84,4,4,24,30,21,75
140840405,14,84,4,5,40,41,6,87
140840406,14,84,4,6,144,65,4,213
140840407,14,84,4,7,134,80,13,227
140840408,14,84,4,8,163,114,14,291
140840409,14,84,4,9,156,122,24,302
140840501,14,84,5,1,72,126,60,258
140840502,14,84,5,2,49,37,107,193
140840503,14,84,5,3,14,20,157,191
140840504,14,84,5,4,133,52,131,316
140840505,14,84,5,5,96,77,75,248
140840506,14,84,5,6,85,93,57,235
140840507,14,84,5,7,101,97,48,246
140840508,14,84,5,8,190,128,25,343
140840509,14,84,5,9,174,57,15,246
140840510,14,84,5,10,161,43,11,215
140840511,14,84,5,11,195,78,7,280
140840512,14,84,5,12,142,135,31,308
140840513,14,84,5,13,161,82,14,257
140840514,14,84,5,14,208,114,39,361
140840515,14,84,5,15,174,87,5,266
140840516,14,84,5,16,223,77,8,308
140840517,14,84,5,17,100,99,8,207
140840518,14,84,5,18,91,107,45,243
140840519,14,84,5,19,93,63,78,234
140840520,14,84,5,20,121,51,16,188
140840521,14,84,5,21,143,94,51,288
140840522,14,84,5,22,147,127,7,281
140840523,14,84,5,23,146,79,28,253
140840524,14,84,5,24,141,61,25,227
140840525,14,84,5,25,90,103,9,202
140840526,14,84,5,26,134,58,14,206
140840527,14,84,5,27,94,66,15,175
140910101,14,91,1,1,74,118,23,215
140910102,14,91,1,2,76,24,2,102
140910103,14,91,1,3,160,36,7,203
140910104,14,91,1,4,134,64,26,224
140910105,14,91,1,5,61,19,10,90
140910106,14,91,1,6,156,43,9,208
140910107,14,91,1,7,178,44,4,226
140910108,14,91,1,8,197,35,5,237
140910109,14,91,1,9,118,26,5,149
140910110,14,91,1,10,183,14,1,198
140910111,14,91,1,11,139,22,11,172
140910112,14,91,1,12,154,41,9,204
140910113,14,91,1,13,221,27,21,269
140910114,14,91,1,14,163,41,33,237
140910115,14,91,1,15,52,39,11,102
140910116,14,91,1,16,190,19,2,211
140910117,14,91,1,17,102,41,8,151
140910118,14,91,1,18,173,39,6,218
140910119,14,91,1,19,89,35,18,142
140910201,14,91,2,1,27,22,41,90
140910202,14,91,2,2,2,5,30,37
140910203,14,91,2,3,32,19,21,72
140910204,14,91,2,4,21,7,20,48
140910205,14,91,2,5,0,1,3,4
140910206,14,91,2,6,4,4,16,24
140910207,14,91,2,7,0,2,2,4
140910208,14,91,2,8,2,2,2,6
140910209,14,91,2,9,147,77,29,253
140910210,14,91,2,10,163,68,15,246
140910211,14,91,2,11,60,34,1,95
140910212,14,91,2,12,3,0,1,4
140910301,14,91,3,1,2,3,1,6
140910302,14,91,3,2,8,2,1,11
140910303,14,91,3,3,120,79,18,217
140910304,14,91,3,4,156,91,35,282
140910305,14,91,3,5,148,70,4,222
140910306,14,91,3,6,129,40,9,178
140910307,14,91,3,7,138,46,12,196
140910308,14,91,3,8,128,55,33,216
140910309,14,91,3,9,208,62,8,278
140910310,14,91,3,10,119,63,2,184
140910311,14,91,3,11,113,49,14,176
140910401,14,91,4,1,89,80,75,244
140910402,14,91,4,2,179,71,19,269
140910403,14,91,4,3,172,50,8,230
140910404,14,91,4,4,189,56,9,254
140910405,14,91,4,5,177,55,24,256
140910406,14,91,4,6,200,31,1,232
140910407,14,91,4,7,255,45,5,305
140910408,14,91,4,8,169,46,4,219
140910409,14,91,4,9,258,79,3,340
140910410,14,91,4,10,97,42,1,140
140910411,14,91,4,11,208,102,5,315
140910412,14,91,4,12,73,32,1,106
140910413,14,91,4,13,259,66,14,339
140910414,14,91,4,14,179,46,3,228
140910415,14,91,4,15,122,71,42,235
140910416,14,91,4,16,101,60,6,167
140910417,14,91,4,17,221,96,6,323
140910418,14,91,4,18,184,51,6,241
140910419,14,91,4,19,63,77,54,194
140910420,14,91,4,20,129,105,39,273
140910501,14,91,5,1,1,2,2,5
140910502,14,91,5,2,76,50,25,151
140910503,14,91,5,3,129,73,16,218
140910504,14,91,5,4,194,86,20,300
140910505,14,91,5,5,124,85,38,247
140910506,14,91,5,6,118,66,16,200
140910507,14,91,5,7,106,38,11,155
140910508,14,91,5,8,63,24,8,95
140910509,14,91,5,9,100,65,25,190
140910510,14,91,5,10,110,57,15,182
140910601,14,91,6,1,0,1,0,1
140910602,14,91,6,2,19,35,46,100
140910603,14,91,6,3,5,13,3,21
140910604,14,91,6,4,2,7,7,16
140910605,14,91,6,5,9,3,9,21
140910606,14,91,6,6,137,75,31,243
140910607,14,91,6,7,152,114,34,300
140910608,14,91,6,8,197,60,25,282
140910609,14,91,6,9,118,50,7,175
140910610,14,91,6,10,180,123,6,309
140910611,14,91,6,11,118,67,21,206
140910612,14,91,6,12,70,90,15,175
140910613,14,91,6,13,107,101,14,222
140910614,14,91,6,14,114,71,10,195
140910615,14,91,6,15,86,73,8,167
140910616,14,91,6,16,103,53,7,163
140910617,14,91,6,17,98,59,18,175
140910618,14,91,6,18,49,55,34,138
140910701,14,91,7,1,6,4,3,13
140910702,14,91,7,2,102,63,31,196
140910703,14,91,7,3,179,108,37,324
140910704,14,91,7,4,157,64,3,224
140910705,14,91,7,5,129,52,6,187
140910706,14,91,7,6,62,54,34,150
140910707,14,91,7,7,191,70,4,265
140910708,14,91,7,8,209,58,1,268
140910709,14,91,7,9,223,85,18,326
140910710,14,91,7,10,103,45,17,165
140910711,14,91,7,11,194,88,2,284
140910712,14,91,7,12,200,85,0,285
140910713,14,91,7,13,272,107,17,396
140910714,14,91,7,14,194,40,2,236
140910715,14,91,7,15,237,91,8,336
140910716,14,91,7,16,168,94,3,265
140910717,14,91,7,17,36,46,83,165
140910718,14,91,7,18,228,61,6,295
140910719,14,91,7,19,135,47,2,184
140910720,14,91,7,20,237,116,26,379
140910721,14,91,7,21,227,113,50,390
140910722,14,91,7,22,181,122,16,319
140910723,14,91,7,23,63,99,70,232
140910801,14,91,8,1,4,4,3,11
140910802,14,91,8,2,36,24,14,74
140910803,14,91,8,3,3,0,1,4
140910804,14,91,8,4,47,24,22,93
140910805,14,91,8,5,126,34,4,164
140910806,14,91,8,6,142,46,3,191
140910807,14,91,8,7,125,39,8,172
140910808,14,91,8,8,54,52,25,131
140910809,14,91,8,9,153,55,4,212
140910810,14,91,8,10,120,84,21,225
140910811,14,91,8,11,108,49,14,171
140910812,14,91,8,12,70,106,58,234
140910813,14,91,8,13,143,108,48,299
140910901,14,91,9,1,172,65,11,248
140910902,14,91,9,2,98,59,3,160
140910903,14,91,9,3,128,20,4,152
140910904,14,91,9,4,199,108,9,316
140910905,14,91,9,5,161,163,19,343
140910906,14,91,9,6,187,51,9,247
140910907,14,91,9,7,83,96,37,216
140910908,14,91,9,8,121,103,22,246
140910909,14,91,9,9,127,88,2,217
140910910,14,91,9,10,124,34,0,158
140910911,14,91,9,11,94,34,1,129
140910912,14,91,9,12,154,62,2,218
140910913,14,91,9,13,112,66,18,196
140910914,14,91,9,14,103,120,73,296
140910915,14,91,9,15,153,122,29,304
140910916,14,91,9,16,162,147,29,338
140910917,14,91,9,17,146,89,4,239
140910918,14,91,9,18,84,45,0,129
140910919,14,91,9,19,158,50,2,210
140910920,14,91,9,20,97,135,8,240
140910921,14,91,9,21,99,203,92,394
140910922,14,91,9,22,100,185,84,369
140910923,14,91,9,23,0,0,0,0
140911001,14,91,10,1,132,67,8,207
140911002,14,91,10,2,168,38,2,208
140911003,14,91,10,3,194,23,1,218
140911004,14,91,10,4,209,118,2,329
140911005,14,91,10,5,159,55,0,214
140911006,14,91,10,6,204,72,3,279
140911007,14,91,10,7,118,36,0,154
140911008,14,91,10,8,172,63,0,235
140911009,14,91,10,9,160,57,0,217
140911010,14,91,10,10,155,77,5,237
140911011,14,91,10,11,176,38,1,215
140911012,14,91,10,12,131,60,2,193
140911013,14,91,10,13,206,52,2,260
140911014,14,91,10,14,164,10,1,175
140911015,14,91,10,15,194,38,0,232
140911016,14,91,10,16,145,22,0,167
140911017,14,91,10,17,182,17,0,199
140911018,14,91,10,18,130,78,1,209
140911019,14,91,10,19,143,33,0,176
140911020,14,91,10,20,72,36,2,110
140911101,14,91,11,1,155,54,1,210
140911102,14,91,11,2,121,35,1,157
140911103,14,91,11,3,145,34,0,179
140911104,14,91,11,4,148,45,0,193
140911105,14,91,11,5,173,82,3,258
140911106,14,91,11,6,64,39,0,103
140911107,14,91,11,7,99,46,0,145
140911108,14,91,11,8,114,77,1,192
140911109,14,91,11,9,161,36,2,199
140911110,14,91,11,10,240,54,3,297
140911111,14,91,11,11,105,38,3,146
140911112,14,91,11,12,201,39,7,247
140911113,14,91,11,13,154,22,2,178
140911114,14,91,11,14,149,31,2,182
140911115,14,91,11,15,147,58,0,205
140911116,14,91,11,16,135,38,0,173
140911117,14,91,11,17,97,23,0,120
140911118,14,91,11,18,114,77,1,192
140911201,14,91,12,1,244,58,7,309
140911202,14,91,12,2,155,74,0,229
140911203,14,91,12,3,146,107,0,253
140911204,14,91,12,4,142,100,15,257
140911205,14,91,12,5,197,97,6,300
140911206,14,91,12,6,99,82,3,184
140911207,14,91,12,7,142,95,29,266
140911208,14,91,12,8,85,151,65,301
140911209,14,91,12,9,114,94,6,214
140911210,14,91,12,10,111,140,13,264
140911211,14,91,12,11,128,109,19,256
140911212,14,91,12,12,110,56,3,169
140911213,14,91,12,13,115,94,8,217
140911214,14,91,12,14,146,104,7,257
140911215,14,91,12,15,142,88,7,237
140911216,14,91,12,16,86,48,0,134
140911217,14,91,12,17,104,73,0,177
140911218,14,91,12,18,136,49,4,189
140911219,14,91,12,19,157,93,5,255
140911220,14,91,12,20,87,113,7,207
140911221,14,91,12,21,133,81,2,216
140911222,14,91,12,22,105,94,7,206
140911223,14,91,12,23,55,78,36,169
140911301,14,91,13,1,0,1,4,5
140911302,14,91,13,2,2,1,5,8
140911303,14,91,13,3,12,2,14,28
140911304,14,91,13,4,4,0,1,5
140911305,14,91,13,5,3,3,1,7
140911306,14,91,13,6,3,4,2,9
140911307,14,91,13,7,1,1,4,6
140911308,14,91,13,8,3,1,3,7
140911309,14,91,13,9,68,24,13,105
140911310,14,91,13,10,75,13,5,93
140911311,14,91,13,11,156,83,32,271
140911312,14,91,13,12,112,42,11,165
140911313,14,91,13,13,117,93,22,232
140911314,14,91,13,14,98,26,2,126
140911315,14,91,13,15,120,92,12,224
140911316,14,91,13,16,50,42,4,96
140911317,14,91,13,17,47,65,5,117
140911318,14,91,13,18,69,42,1,112
140911319,14,91,13,19,55,46,3,104
140911320,14,91,13,20,69,31,3,103
140911321,14,91,13,21,58,31,0,89
140911322,14,91,13,22,68,15,0,83
140911323,14,91,13,23,97,74,10,181
140911401,14,91,14,1,1,2,11,14
140911402,14,91,14,2,2,7,12,21
140911403,14,91,14,3,2,7,1,10
140911404,14,91,14,4,7,2,8,17
140911405,14,91,14,5,8,15,9,32
140911406,14,91,14,6,82,46,6,134
140911407,14,91,14,7,234,38,24,296
140911408,14,91,14,8,170,53,10,233
140911409,14,91,14,9,180,56,39,275
140911410,14,91,14,10,232,95,34,361
140911411,14,91,14,11,130,52,3,185
140911412,14,91,14,12,122,57,20,199
140911413,14,91,14,13,208,59,9,276
140911414,14,91,14,14,198,33,1,232
140911415,14,91,14,15,124,39,4,167
140911501,14,91,15,1,5,0,0,5
140911502,14,91,15,2,61,30,22,113
140911503,14,91,15,3,116,57,19,192
140911504,14,91,15,4,115,49,25,189
140911505,14,91,15,5,88,53,20,161
140911506,14,91,15,6,100,66,13,179
140911507,14,91,15,7,87,55,36,178
140911508,14,91,15,8,136,52,20,208
140911509,14,91,15,9,156,48,3,207
140911510,14,91,15,10,139,73,12,224
140911601,14,91,16,1,3,0,4,7
140911602,14,91,16,2,5,3,10,18
140911603,14,91,16,3,0,0,3,3
140911604,14,91,16,4,0,1,6,7
140911605,14,91,16,5,17,26,18,61
140911606,14,91,16,6,8,4,13,25
140911607,14,91,16,7,0,0,5,5
140911608,14,91,16,8,67,50,20,137
140911609,14,91,16,9,83,30,16,129
140911610,14,91,16,10,47,23,12,82
140911701,14,91,17,1,0,2,0,2
140911702,14,91,17,2,0,1,1,2
140911703,14,91,17,3,3,5,1,9
140911704,14,91,17,4,1,0,0,1
140911705,14,91,17,5,0,0,4,4
140911706,14,91,17,6,121,86,23,230
140911707,14,91,17,7,82,59,14,155
140911708,14,91,17,8,121,71,4,196
140911709,14,91,17,9,160,45,12,217
140911710,14,91,17,10,81,65,3,149
140911711,14,91,17,11,85,73,4,162
140911712,14,91,17,12,73,62,5,140
140911713,14,91,17,13,148,90,10,248
140911714,14,91,17,14,100,54,6,160
140911715,14,91,17,15,32,45,21,98
140911801,14,91,18,1,0,4,3,7
140911802,14,91,18,2,0,4,1,5
140911803,14,91,18,3,1,5,5,11
140911804,14,91,18,4,4,28,35,67
140911805,14,91,18,5,14,14,23,51
140911806,14,91,18,6,71,38,4,113
140911807,14,91,18,7,25,30,24,79
140911808,14,91,18,8,74,88,27,189
140911809,14,91,18,9,116,34,16,166
140911810,14,91,18,10,31,5,0,36
140911901,14,91,19,1,10,12,15,37
140911902,14,91,19,2,15,5,10,30
140911903,14,91,19,3,1,0,0,1
140911904,14,91,19,4,5,5,3,13
140911905,14,91,19,5,5,5,1,11
140911906,14,91,19,6,117,54,21,192
140911907,14,91,19,7,79,29,5,113
140911908,14,91,19,8,120,75,25,220
140911909,14,91,19,9,91,93,13,197
140911910,14,91,19,10,103,72,15,190
140911911,14,91,19,11,145,119,9,273
140911912,14,91,19,12,26,15,0,41
140911913,14,91,19,13,73,78,40,191
140911914,14,91,19,14,55,59,30,144
140980101,14,98,1,1,0,4,2,6
140980102,14,98,1,2,10,6,1,17
140980103,14,98,1,3,6,25,2,33
140980104,14,98,1,4,4,13,6,23
140980105,14,98,1,5,2,9,2,13
140980106,14,98,1,6,5,12,1,18
140980107,14,98,1,7,4,7,6,17
140980108,14,98,1,8,70,94,12,176
140980109,14,98,1,9,152,76,8,236
140980110,14,98,1,10,85,143,22,250
140980111,14,98,1,11,107,81,20,208
140980112,14,98,1,12,107,87,6,200
140980113,14,98,1,13,134,105,3,242
140980114,14,98,1,14,67,125,17,209
140980115,14,98,1,15,159,77,7,243
140980116,14,98,1,16,178,64,3,245
140980117,14,98,1,17,121,134,29,284
140980201,14,98,2,1,6,4,0,10
140980202,14,98,2,2,14,15,7,36
140980203,14,98,2,3,25,46,7,78
140980204,14,98,2,4,37,5,3,45
140980205,14,98,2,5,6,29,2,37
140980206,14,98,2,6,4,7,7,18
140980207,14,98,2,7,13,4,1,18
140980208,14,98,2,8,129,120,10,259
140980209,14,98,2,9,64,97,22,183
140980210,14,98,2,10,138,120,4,262
140980211,14,98,2,11,194,109,3,306
140980301,14,98,3,1,8,9,2,19
140980302,14,98,3,2,2,23,1,26
140980303,14,98,3,3,2,12,2,16
140980304,14,98,3,4,101,127,15,243
140980305,14,98,3,5,117,167,13,297
140980306,14,98,3,6,138,166,5,309
140980307,14,98,3,7,168,39,1,208
140980308,14,98,3,8,139,145,8,292
140980309,14,98,3,9,90,105,8,203
140980310,14,98,3,10,87,100,10,197
140980311,14,98,3,11,111,116,20,247
140980401,14,98,4,1,1,20,0,21
140980402,14,98,4,2,22,25,1,48
140980403,14,98,4,3,8,15,1,24
140980404,14,98,4,4,5,13,1,19
140980405,14,98,4,5,5,16,0,21
140980406,14,98,4,6,16,25,5,46
140980407,14,98,4,7,43,144,16,203
140980408,14,98,4,8,75,141,12,228
140980409,14,98,4,9,58,39,4,101
140980501,14,98,5,1,6,10,1,17
140980502,14,98,5,2,15,35,13,63
140980503,14,98,5,3,8,15,0,23
140980504,14,98,5,4,6,6,0,12
140980505,14,98,5,5,54,47,6,107
140980506,14,98,5,6,96,30,8,134
140980507,14,98,5,7,14,9,11,34
140980508,14,98,5,8,12,7,1,20
140980509,14,98,5,9,25,15,8,48
140980510,14,98,5,10,109,130,28,267
140980511,14,98,5,11,136,108,2,246
140980512,14,98,5,12,153,132,5,290
140980513,14,98,5,13,99,117,9,225
140980514,14,98,5,14,85,100,3,188
140980515,14,98,5,15,128,87,8,223
140980516,14,98,5,16,110,84,6,200
140980517,14,98,5,17,153,125,1,279
140980601,14,98,6,1,3,15,7,25
140980602,14,98,6,2,9,42,15,66
140980603,14,98,6,3,13,29,3,45
140980604,14,98,6,4,5,19,21,45
140980605,14,98,6,5,19,10,5,34
140980606,14,98,6,6,31,11,8,50
140980607,14,98,6,7,32,39,4,75
140980608,14,98,6,8,40,43,10,93
140980609,14,98,6,9,26,8,1,35
140980701,14,98,7,1,9,13,5,27
140980702,14,98,7,2,4,22,23,49
140980703,14,98,7,3,9,28,9,46
140980704,14,98,7,4,36,32,1,69
140980705,14,98,7,5,4,13,3,20
140980706,14,98,7,6,16,11,3,30
140980707,14,98,7,7,11,38,6,55
140980708,14,98,7,8,11,29,8,48
140980801,14,98,8,1,15,29,5,49
140980802,14,98,8,2,13,32,4,49
140980803,14,98,8,3,30,31,6,67
140980804,14,98,8,4,15,46,11,72
140980805,14,98,8,5,5,12,3,20
140980806,14,98,8,6,40,30,1,71
140980807,14,98,8,7,73,86,7,166
140980808,14,98,8,8,112,141,12,265
140980809,14,98,8,9,54,116,23,193
140980810,14,98,8,10,39,92,16,147
140980811,14,98,8,11,62,32,12,106
140980901,14,98,9,1,22,20,4,46
140980902,14,98,9,2,59,78,8,145
140980903,14,98,9,3,36,14,10,60
140980904,14,98,9,4,76,98,22,196
140980905,14,98,9,5,139,77,9,225
140980906,14,98,9,6,149,108,5,262
140980907,14,98,9,7,173,61,19,253
140980908,14,98,9,8,201,37,5,243
140980909,14,98,9,9,114,111,31,256
140980910,14,98,9,10,142,59,12,213
140980911,14,98,9,11,108,9,1,118
140980912,14,98,9,12,155,183,19,357
140980913,14,98,9,13,188,73,4,265
140980914,14,98,9,14,141,101,16,258
140981001,14,98,10,1,2,5,5,12
140981002,14,98,10,2,2,11,4,17
140981003,14,98,10,3,29,54,89,172
140981004,14,98,10,4,13,31,7,51
140981005,14,98,10,5,21,16,8,45
140981006,14,98,10,6,13,22,3,38
140981007,14,98,10,7,20,27,9,56
140981008,14,98,10,8,35,18,10,63
140981009,14,98,10,9,53,104,9,166
140981010,14,98,10,10,76,112,9,197
140981011,14,98,10,11,123,171,11,305
140981012,14,98,10,12,78,131,7,216
140981013,14,98,10,13,125,140,12,277
140981014,14,98,10,14,116,116,8,240
140981101,14,98,11,1,33,47,6,86
140981102,14,98,11,2,27,56,4,87
140981103,14,98,11,3,9,13,0,22
140981104,14,98,11,4,9,9,4,22
140981105,14,98,11,5,13,17,2,32
140981106,14,98,11,6,31,41,25,97
140981107,14,98,11,7,18,44,4,66
140981108,14,98,11,8,21,14,3,38
140981109,14,98,11,9,71,172,6,249
140981110,14,98,11,10,86,91,17,194
140981111,14,98,11,11,123,128,16,267
140981201,14,98,12,1,27,36,7,70
140981202,14,98,12,2,42,31,13,86
140981203,14,98,12,3,20,70,22,112
140981204,14,98,12,4,55,66,9,130
140981205,14,98,12,5,9,24,2,35
140981206,14,98,12,6,40,44,12,96
140981207,14,98,12,7,116,142,3,261
140981208,14,98,12,8,146,113,0,259
140981209,14,98,12,9,103,73,8,184
140981210,14,98,12,10,102,81,8,191
140981211,14,98,12,11,100,74,0,174
140981212,14,98,12,12,101,101,8,210
140981301,14,98,13,1,25,16,8,49
140981302,14,98,13,2,27,19,2,48
140981303,14,98,13,3,22,13,6,41
140981304,14,98,13,4,22,13,7,42
140981305,14,98,13,5,14,13,8,35
140981306,14,98,13,6,15,10,4,29
140981307,14,98,13,7,9,4,1,14
140981308,14,98,13,8,23,8,1,32
140981309,14,98,13,9,18,17,7,42
140981310,14,98,13,10,30,28,6,64
140981311,14,98,13,11,74,113,41,228
140981312,14,98,13,12,173,133,19,325
140981313,14,98,13,13,55,57,50,162
140981401,14,98,14,1,33,12,12,57
140981402,14,98,14,2,18,22,2,42
140981403,14,98,14,3,16,14,14,44
140981404,14,98,14,4,20,23,12,55
140981405,14,98,14,5,17,24,12,53
140981406,14,98,14,6,18,13,9,40
140981407,14,98,14,7,18,11,9,38
140981408,14,98,14,8,10,11,10,31
140981409,14,98,14,9,71,41,17,129
140981410,14,98,14,10,143,80,41,264
140981501,14,98,15,1,110,146,42,298
140981502,14,98,15,2,64,98,133,295
140981503,14,98,15,3,134,172,41,347
140981504,14,98,15,4,176,90,14,280
140981505,14,98,15,5,83,118,26,227
140981506,14,98,15,6,65,134,11,210
140981507,14,98,15,7,129,143,13,285
140981508,14,98,15,8,108,121,7,236
140981509,14,98,15,9,90,198,24,312
140981510,14,98,15,10,141,160,28,329
140981511,14,98,15,11,231,44,0,275
140981512,14,98,15,12,130,32,2,164
140981513,14,98,15,13,117,202,33,352
140981514,14,98,15,14,186,126,1,313
140981515,14,98,15,15,115,128,1,244
140981601,14,98,16,1,92,109,46,247
140981602,14,98,16,2,126,148,80,354
140981603,14,98,16,3,46,109,37,192
140981604,14,98,16,4,51,130,21,202
140981605,14,98,16,5,200,180,6,386
140981606,14,98,16,6,65,68,23,156
140981607,14,98,16,7,86,104,29,219
140981608,14,98,16,8,124,67,2,193
140981609,14,98,16,9,170,196,33,399
140981610,14,98,16,10,187,163,18,368
140981611,14,98,16,11,207,132,4,343
140981612,14,98,16,12,228,114,2,344
140981613,14,98,16,13,103,81,0,184
140981614,14,98,16,14,149,46,0,195
140981615,14,98,16,15,108,65,0,173
140981701,14,98,17,1,161,210,49,420
140981702,14,98,17,2,60,149,70,279
140981703,14,98,17,3,181,101,10,292
140981704,14,98,17,4,111,56,38,205
140981705,14,98,17,5,194,185,9,388
140981706,14,98,17,6,94,120,16,230
140981707,14,98,17,7,107,87,7,201
140981708,14,98,17,8,171,116,3,290
140981709,14,98,17,9,81,156,8,245
140981710,14,98,17,10,148,107,6,261
140981711,14,98,17,11,141,171,4,316
140981712,14,98,17,12,230,166,17,413
140981713,14,98,17,13,104,153,11,268
140981801,14,98,18,1,176,213,6,395
140981802,14,98,18,2,196,186,10,392
140981803,14,98,18,3,233,202,9,444
140981804,14,98,18,4,226,178,22,426
140981805,14,98,18,5,185,157,23,365
140981806,14,98,18,6,150,129,11,290
140981807,14,98,18,7,150,162,0,312
140981808,14,98,18,8,153,155,12,320
140981809,14,98,18,9,267,168,13,448
140981810,14,98,18,10,176,213,43,432
140981811,14,98,18,11,174,142,1,317
140981812,14,98,18,12,124,161,8,293
140981813,14,98,18,13,136,105,60,301
140981901,14,98,19,1,117,70,10,197
140981902,14,98,19,2,130,174,277,581
140981903,14,98,19,3,78,154,90,322
140981904,14,98,19,4,34,105,87,226
140981905,14,98,19,5,57,109,40,206
140981906,14,98,19,6,80,92,47,219
140981907,14,98,19,7,57,103,53,213
140981908,14,98,19,8,44,146,53,243
140981909,14,98,19,9,86,108,16,210
140981910,14,98,19,10,124,96,2,222
140981911,14,98,19,11,78,194,21,293
140981912,14,98,19,12,158,159,6,323
140982001,14,98,20,1,49,56,9,114
140982002,14,98,20,2,164,50,11,225
140982003,14,98,20,3,204,72,0,276
140982004,14,98,20,4,116,53,0,169
140982005,14,98,20,5,124,13,0,137
140982006,14,98,20,6,187,127,2,316
140982007,14,98,20,7,156,86,0,242
140982008,14,98,20,8,190,149,13,352
140982009,14,98,20,9,89,66,49,204
140982010,14,98,20,10,186,95,3,284
140982011,14,98,20,11,130,51,0,181
140982012,14,98,20,12,113,92,0,205
140982013,14,98,20,13,175,41,0,216
140982014,14,98,20,14,176,51,1,228
140982015,14,98,20,15,122,30,1,153
140982016,14,98,20,16,171,83,0,254
140982017,14,98,20,17,159,149,1,309
140982018,14,98,20,18,223,108,12,343
140982019,14,98,20,19,83,6,0,89
140982020,14,98,20,20,185,11,0,196
140982021,14,98,20,21,204,26,0,230
140982022,14,98,20,22,162,47,0,209
140982101,14,98,21,1,81,157,23,261
140982102,14,98,21,2,108,42,9,159
140982103,14,98,21,3,244,156,10,410
140982104,14,98,21,4,211,47,2,260
140982105,14,98,21,5,135,93,0,228
140982106,14,98,21,6,147,48,3,198
140982107,14,98,21,7,168,62,0,230
140982108,14,98,21,8,244,99,2,345
140982109,14,98,21,9,247,90,0,337
140982110,14,98,21,10,181,119,12,312
140982111,14,98,21,11,169,140,7,316
140982112,14,98,21,12,47,151,39,237
140982113,14,98,21,13,62,171,38,271
140982114,14,98,21,14,139,164,22,325
140982201,14,98,22,1,149,230,13,392
140982202,14,98,22,2,316,77,1,394
140982203,14,98,22,3,176,154,6,336
140982204,14,98,22,4,51,108,18,177
140982205,14,98,22,5,271,115,2,388
140982206,14,98,22,6,201,149,5,355
140982207,14,98,22,7,209,110,7,326
140982208,14,98,22,8,106,165,21,292
140982209,14,98,22,9,97,117,47,261
140982210,14,98,22,10,39,217,89,345
140982211,14,98,22,11,50,223,17,290
140982212,14,98,22,12,39,116,59,214
140982301,14,98,23,1,296,58,0,354
140982302,14,98,23,2,130,124,3,257
140982303,14,98,23,3,155,65,7,227
140982304,14,98,23,4,236,155,13,404
140982305,14,98,23,5,96,70,3,169
140982306,14,98,23,6,151,105,6,262
140982307,14,98,23,7,110,76,5,191
140982308,14,98,23,8,240,78,6,324
140982309,14,98,23,9,100,142,10,252
140982310,14,98,23,10,127,118,7,252
140982311,14,98,23,11,107,123,27,257
140982312,14,98,23,12,200,199,6,405
140982313,14,98,23,13,125,173,21,319
140982314,14,98,23,14,59,109,48,216
140982401,14,98,24,1,187,86,0,273
140982402,14,98,24,2,171,38,1,210
140982403,14,98,24,3,79,58,0,137
140982404,14,98,24,4,217,96,2,315
140982405,14,98,24,5,227,104,20,351
140982406,14,98,24,6,250,106,1,357
140982407,14,98,24,7,168,17,1,186
140982408,14,98,24,8,173,27,1,201
140982409,14,98,24,9,254,55,0,309
140982410,14,98,24,10,211,80,1,292
140982411,14,98,24,11,234,122,2,358
140982412,14,98,24,12,184,130,0,314
140982413,14,98,24,13,122,187,10,319
140982414,14,98,24,14,229,110,2,341
140982415,14,98,24,15,192,28,0,220
140982416,14,98,24,16,168,114,1,283
140982417,14,98,24,17,208,86,9,303
140982418,14,98,24,18,139,89,0,228
140982419,14,98,24,19,145,21,0,166
140982420,14,98,24,20,238,113,2,353
140982421,14,98,24,21,145,100,4,249
140982501,14,98,25,1,196,85,8,289
140982502,14,98,25,2,166,198,6,370
140982503,14,98,25,3,175,104,5,284
140982504,14,98,25,4,121,142,13,276
140982505,14,98,25,5,159,181,22,362
140982506,14,98,25,6,160,150,48,358
140982507,14,98,25,7,73,164,86,323
140982508,14,98,25,8,110,162,52,324
140982509,14,98,25,9,82,130,19,231
140982510,14,98,25,10,147,73,17,237
140982511,14,98,25,11,100,269,36,405
140982512,14,98,25,12,70,187,132,389
140982601,14,98,26,1,110,165,6,281
140982602,14,98,26,2,113,162,9,284
140982603,14,98,26,3,246,185,10,441
140982604,14,98,26,4,172,184,10,366
140982605,14,98,26,5,131,139,8,278
140982606,14,98,26,6,140,97,5,242
140982607,14,98,26,7,83,225,13,321
140982608,14,98,26,8,156,126,12,294
140982609,14,98,26,9,107,96,53,256
140982610,14,98,26,10,62,144,40,246
140982611,14,98,26,11,56,139,60,255
140982612,14,98,26,12,82,169,23,274
140982613,14,98,26,13,28,100,44,172
140982701,14,98,27,1,95,208,63,366
140982702,14,98,27,2,212,151,10,373
140982703,14,98,27,3,197,157,3,357
140982704,14,98,27,4,113,111,0,224
140982705,14,98,27,5,140,113,11,264
140982706,14,98,27,6,117,132,4,253
140982707,14,98,27,7,136,189,7,332
140982708,14,98,27,8,170,136,4,310
140982801,14,98,28,1,250,97,30,377
140982802,14,98,28,2,199,109,11,319
140982803,14,98,28,3,145,34,4,183
140982804,14,98,28,4,125,56,4,185
140982805,14,98,28,5,55,102,48,205
140982806,14,98,28,6,74,118,34,226
140982807,14,98,28,7,80,94,34,208
140982808,14,98,28,8,138,38,3,179
140982809,14,98,28,9,171,87,11,269
140982810,14,98,28,10,158,89,5,252
140982811,14,98,28,11,77,83,22,182
140982812,14,98,28,12,145,103,19,267
140982901,14,98,29,1,139,90,14,243
140982902,14,98,29,2,125,109,43,277
140982903,14,98,29,3,89,34,16,139
140982904,14,98,29,4,142,61,7,210
140982905,14,98,29,5,69,88,31,188
140982906,14,98,29,6,118,81,31,230
140982907,14,98,29,7,104,25,7,136
140982908,14,98,29,8,114,46,1,161
140982909,14,98,29,9,71,103,7,181
140982910,14,98,29,10,127,104,23,254
140982911,14,98,29,11,123,80,20,223
140982912,14,98,29,12,57,125,29,211
140982913,14,98,29,13,148,77,30,255
140982914,14,98,29,14,163,118,25,306
141050101,14,105,1,1,13,41,27,81
141050102,14,105,1,2,4,8,22,34
141050103,14,105,1,3,4,65,53,122
141050104,14,105,1,4,6,13,15,34
141050105,14,105,1,5,7,7,6,20
141050106,14,105,1,6,12,37,30,79
141050107,14,105,1,7,5,21,30,56
141050108,14,105,1,8,13,34,38,85
141050109,14,105,1,9,26,52,45,123
141050110,14,105,1,10,10,35,28,73
141050111,14,105,1,11,14,14,24,52
141050112,14,105,1,12,104,61,18,183
141050113,14,105,1,13,55,104,36,195
141050114,14,105,1,14,70,130,57,257
141050201,14,105,2,1,7,3,16,26
141050202,14,105,2,2,2,10,4,16
141050203,14,105,2,3,12,29,13,54
141050204,14,105,2,4,10,8,15,33
141050205,14,105,2,5,22,31,18,71
141050206,14,105,2,6,10,29,17,56
141050207,14,105,2,7,8,12,7,27
141050208,14,105,2,8,18,21,26,65
141050209,14,105,2,9,9,26,13,48
141050210,14,105,2,10,69,54,9,132
141050211,14,105,2,11,62,144,24,230
141050212,14,105,2,12,112,75,22,209
141050213,14,105,2,13,112,74,7,193
141050214,14,105,2,14,68,154,24,246
141050215,14,105,2,15,125,156,12,293
141050216,14,105,2,16,125,199,21,345
141050217,14,105,2,17,79,155,62,296
141050301,14,105,3,1,11,3,3,17
141050302,14,105,3,2,6,17,17,40
141050303,14,105,3,3,12,37,6,55
141050304,14,105,3,4,15,2,6,23
141050305,14,105,3,5,40,38,23,101
141050306,14,105,3,6,24,5,13,42
141050307,14,105,3,7,9,21,8,38
141050308,14,105,3,8,36,66,41,143
141050309,14,105,3,9,176,145,36,357
141050310,14,105,3,10,96,145,20,261
141050311,14,105,3,11,54,86,13,153
141050312,14,105,3,12,86,128,10,224
141050313,14,105,3,13,116,144,70,330
141050314,14,105,3,14,129,164,18,311
141050315,14,105,3,15,119,177,25,321
141050316,14,105,3,16,170,107,5,282
141050401,14,105,4,1,2,7,4,13
141050402,14,105,4,2,10,20,20,50
141050403,14,105,4,3,6,12,3,21
141050404,14,105,4,4,4,25,26,55
141050405,14,105,4,5,8,22,14,44
141050406,14,105,4,6,15,22,12,49
141050407,14,105,4,7,18,15,30,63
141050408,14,105,4,8,5,19,3,27
141050409,14,105,4,9,1,15,23,39
141050410,14,105,4,10,18,53,22,93
141050411,14,105,4,11,7,9,6,22
141050412,14,105,4,12,9,28,5,42
141050413,14,105,4,13,7,12,9,28
141050414,14,105,4,14,27,94,15,136
141050415,14,105,4,15,124,104,12,240
141050416,14,105,4,16,33,25,16,74
141050501,14,105,5,1,9,18,16,43
141050502,14,105,5,2,29,14,56,99
141050503,14,105,5,3,33,41,168,242
141050504,14,105,5,4,30,42,94,166
141050505,14,105,5,5,80,184,33,297
141050506,14,105,5,6,176,63,1,240
141050507,14,105,5,7,136,82,12,230
141050508,14,105,5,8,154,110,21,285
141050509,14,105,5,9,115,92,1,208
141050510,14,105,5,10,104,165,17,286
141050511,14,105,5,11,85,105,3,193
141050512,14,105,5,12,104,103,13,220
141050513,14,105,5,13,116,18,1,135
141050514,14,105,5,14,105,154,125,384
141050515,14,105,5,15,87,102,55,244
141050601,14,105,6,1,24,29,14,67
141050602,14,105,6,2,17,17,45,79
141050603,14,105,6,3,9,21,25,55
141050604,14,105,6,4,41,34,38,113
141050605,14,105,6,5,22,20,39,81
141050606,14,105,6,6,51,100,17,168
141050607,14,105,6,7,81,93,6,180
141050608,14,105,6,8,163,111,18,292
141050609,14,105,6,9,152,132,6,290
141050610,14,105,6,10,218,115,8,341
141050611,14,105,6,11,162,124,23,309
141050612,14,105,6,12,176,170,23,369
141050613,14,105,6,13,23,51,24,98
141120101,14,112,1,1,1,4,11,16
141120102,14,112,1,2,0,8,31,39
141120103,14,112,1,3,1,12,33,46
141120104,14,112,1,4,6,39,49,94
141120105,14,112,1,5,6,14,22,42
141120106,14,112,1,6,17,37,29,83
141120107,14,112,1,7,2,2,20,24
141120108,14,112,1,8,8,10,19,37
141120109,14,112,1,9,79,83,33,195
141120110,14,112,1,10,62,101,25,188
141120111,14,112,1,11,55,68,5,128
141120112,14,112,1,12,56,146,85,287
141120113,14,112,1,13,81,100,15,196
141120114,14,112,1,14,22,48,12,82
141120115,14,112,1,15,46,110,19,175
141120201,14,112,2,1,26,57,89,172
141120202,14,112,2,2,1,5,17,23
141120203,14,112,2,3,2,2,16,20
141120204,14,112,2,4,1,5,13,19
141120205,14,112,2,5,0,0,19,19
141120206,14,112,2,6,0,2,49,51
141120207,14,112,2,7,24,54,50,128
141120301,14,112,3,1,8,6,20,34
141120302,14,112,3,2,17,34,37,88
141120303,14,112,3,3,2,2,34,38
141120304,14,112,3,4,27,62,95,184
141120305,14,112,3,5,6,6,58,70
141120306,14,112,3,6,3,21,95,119
141120307,14,112,3,7,0,0,68,68
141120308,14,112,3,8,2,1,33,36
141120309,14,112,3,9,0,1,67,68
141120310,14,112,3,10,48,97,52,197
141120311,14,112,3,11,24,85,77,186
141120312,14,112,3,12,70,124,53,247
141120313,14,112,3,13,27,143,53,223
141120314,14,112,3,14,18,34,14,66
141190101,14,119,1,1,24,117,112,253
141190102,14,119,1,2,37,17,19,73
141190103,14,119,1,3,13,30,7,50
141190104,14,119,1,4,6,10,1,17
141190105,14,119,1,5,15,8,2,25
141190106,14,119,1,6,65,123,12,200
141190107,14,119,1,7,81,102,4,187
141190108,14,119,1,8,115,190,17,322
141190109,14,119,1,9,143,195,28,366
141190110,14,119,1,10,66,84,2,152
141190111,14,119,1,11,111,138,4,253
141190112,14,119,1,12,104,191,23,318
141190113,14,119,1,13,156,80,1,237
141190114,14,119,1,14,192,75,7,274
141190115,14,119,1,15,165,132,19,316
141190201,14,119,2,1,7,2,4,13
141190202,14,119,2,2,6,10,5,21
141190203,14,119,2,3,3,8,3,14
141190204,14,119,2,4,5,3,8,16
141190205,14,119,2,5,5,34,15,54
141190206,14,119,2,6,0,6,2,8
141190207,14,119,2,7,0,3,1,4
141190208,14,119,2,8,2,2,0,4
141190209,14,119,2,9,7,13,3,23
141190210,14,119,2,10,0,14,1,15
141190211,14,119,2,11,2,21,3,26
141190212,14,119,2,12,36,78,30,144
141190213,14,119,2,13,118,170,25,313
141190214,14,119,2,14,52,147,39,238
141190215,14,119,2,15,120,75,16,211
141190301,14,119,3,1,43,53,11,107
141190302,14,119,3,2,20,44,24,88
141190303,14,119,3,3,21,29,17,67
141190304,14,119,3,4,14,16,6,36
141190305,14,119,3,5,14,12,4,30
141190306,14,119,3,6,113,163,9,285
141190307,14,119,3,7,123,112,48,283
141190308,14,119,3,8,108,143,30,281
141190309,14,119,3,9,33,59,3,95
141190310,14,119,3,10,78,144,8,230
141190311,14,119,3,11,79,118,24,221
141190312,14,119,3,12,134,49,13,196
141190313,14,119,3,13,106,94,7,207
141190314,14,119,3,14,220,179,1,400
141190315,14,119,3,15,237,72,3,312
141190316,14,119,3,16,112,212,6,330
141190401,14,119,4,1,5,4,4,13
141190402,14,119,4,2,10,19,1,30
141190403,14,119,4,3,1,13,4,18
141190404,14,119,4,4,18,6,2,26
141190405,14,119,4,5,11,7,2,20
141190406,14,119,4,6,10,19,4,33
141190407,14,119,4,7,12,21,18,51
141190408,14,119,4,8,12,22,20,54
141190409,14,119,4,9,32,53,33,118
141190410,14,119,4,10,226,126,10,362
141190411,14,119,4,11,151,214,6,371
141190412,14,119,4,12,126,117,5,248
141190413,14,119,4,13,175,133,35,343
141190414,14,119,4,14,89,188,11,288
141190415,14,119,4,15,102,126,5,233
141190416,14,119,4,16,41,152,9,202
141190417,14,119,4,17,109,91,5,205
141190418,14,119,4,18,177,193,9,379
141190419,14,119,4,19,137,134,2,273
141190420,14,119,4,20,80,163,12,255
141190501,14,119,5,1,10,35,37,82
141190502,14,119,5,2,4,10,0,14
141190503,14,119,5,3,34,23,6,63
141190504,14,119,5,4,24,43,4,71
141190505,14,119,5,5,21,13,4,38
141190506,14,119,5,6,10,16,6,32
141190507,14,119,5,7,6,5,0,11
141190508,14,119,5,8,7,22,7,36
141190509,14,119,5,9,9,2,5,16
141190510,14,119,5,10,9,3,4,16
141190511,14,119,5,11,40,205,24,269
141190512,14,119,5,12,80,173,16,269
141190513,14,119,5,13,108,95,14,217
141190514,14,119,5,14,121,145,19,285
141190515,14,119,5,15,108,127,3,238
141190601,14,119,6,1,103,183,40,326
141190602,14,119,6,2,141,163,23,327
141190603,14,119,6,3,161,120,11,292
141190604,14,119,6,4,169,69,3,241
141190605,14,119,6,5,135,203,23,361
141190606,14,119,6,6,68,260,29,357
141190607,14,119,6,7,102,184,14,300
141190608,14,119,6,8,122,95,1,218
141190609,14,119,6,9,103,139,10,252
141190610,14,119,6,10,106,103,26,235
141190611,14,119,6,11,104,97,71,272
141190612,14,119,6,12,127,121,26,274
141190613,14,119,6,13,136,82,4,222
141190614,14,119,6,14,108,45,3,156
141190615,14,119,6,15,114,81,7,202
141190616,14,119,6,16,118,99,12,229
141190617,14,119,6,17,105,109,1,215
141190618,14,119,6,18,98,140,10,248
141190619,14,119,6,19,122,146,7,275
141190620,14,119,6,20,87,150,30,267
141190621,14,119,6,21,49,147,72,268
141190701,14,119,7,1,109,121,61,291
141190702,14,119,7,2,95,169,27,291
141190703,14,119,7,3,126,246,55,427
141190704,14,119,7,4,145,178,20,343
141190705,14,119,7,5,199,105,18,322
141190706,14,119,7,6,197,148,8,353
141190707,14,119,7,7,189,107,5,301
141190708,14,119,7,8,86,146,58,290
141190709,14,119,7,9,95,154,34,283
141190710,14,119,7,10,190,148,5,343
141190711,14,119,7,11,101,119,5,225
141190712,14,119,7,12,119,127,7,253
141190713,14,119,7,13,121,117,17,255
141190714,14,119,7,14,76,90,40,206
141190801,14,119,8,1,59,92,93,244
141190802,14,119,8,2,47,128,33,208
141190803,14,119,8,3,79,107,4,190
141190804,14,119,8,4,81,144,8,233
141190805,14,119,8,5,76,152,7,235
141190806,14,119,8,6,85,86,39,210
141190807,14,119,8,7,107,96,18,221
141190808,14,119,8,8,158,152,21,331
141190809,14,119,8,9,207,110,3,320
141190810,14,119,8,10,174,147,5,326
141190811,14,119,8,11,178,113,5,296
141190812,14,119,8,12,122,147,44,313
141190813,14,119,8,13,173,113,5,291
141190814,14,119,8,14,177,105,10,292
141190815,14,119,8,15,175,190,21,386
141190816,14,119,8,16,104,118,14,236
141190817,14,119,8,17,62,117,50,229
141190901,14,119,9,1,139,87,16,242
141190902,14,119,9,2,76,178,21,275
141190903,14,119,9,3,75,82,12,169
141190904,14,119,9,4,152,81,7,240
141190905,14,119,9,5,147,82,9,238
141190906,14,119,9,6,86,124,10,220
141190907,14,119,9,7,89,104,2,195
141190908,14,119,9,8,104,127,0,231
141190909,14,119,9,9,97,144,1,242
141190910,14,119,9,10,82,72,4,158
141190911,14,119,9,11,145,135,8,288
141190912,14,119,9,12,156,191,5,352
141190913,14,119,9,13,81,101,0,182
141190914,14,119,9,14,157,145,5,307
141190915,14,119,9,15,109,103,8,220
141190916,14,119,9,16,181,115,7,303
141190917,14,119,9,17,148,184,7,339
141260101,14,126,1,1,6,24,13,43
141260102,14,126,1,2,6,26,12,44
141260103,14,126,1,3,2,12,27,41
141260104,14,126,1,4,0,8,43,51
141260105,14,126,1,5,2,4,6,12
141260106,14,126,1,6,0,7,25,32
141260107,14,126,1,7,2,7,35,44
141260108,14,126,1,8,11,11,30,52
141260109,14,126,1,9,30,57,29,116
141260201,14,126,2,1,0,1,44,45
141260202,14,126,2,2,1,0,8,9
141260203,14,126,2,3,1,5,19,25
141260204,14,126,2,4,0,4,56,60
141260205,14,126,2,5,0,0,23,23
141260206,14,126,2,6,10,23,171,204
141260207,14,126,2,7,3,2,29,34
141260208,14,126,2,8,16,37,39,92
141260301,14,126,3,1,1,2,13,16
141260302,14,126,3,2,0,1,2,3
141260303,14,126,3,3,18,43,50,111
141260304,14,126,3,4,56,97,83,236
141260305,14,126,3,5,6,10,30,46
141260306,14,126,3,6,5,12,23,40
141260307,14,126,3,7,59,88,34,181
141260308,14,126,3,8,101,122,23,246
141260309,14,126,3,9,93,62,7,162
141260310,14,126,3,10,62,55,5,122
141260311,14,126,3,11,151,93,4,248
141260312,14,126,3,12,164,64,3,231
141260313,14,126,3,13,100,75,36,211
141260314,14,126,3,14,96,145,41,282
141260401,14,126,4,1,19,40,35,94
141260402,14,126,4,2,0,10,25,35
141260403,14,126,4,3,3,8,23,34
141260404,14,126,4,4,28,30,44,102
141260405,14,126,4,5,8,17,15,40
141260406,14,126,4,6,58,53,23,134
141260501,14,126,5,1,1,4,12,17
141260502,14,126,5,2,6,12,78,96
141260503,14,126,5,3,0,0,6,6
141260504,14,126,5,4,16,12,68,96
141260505,14,126,5,5,8,22,54,84
141260506,14,126,5,6,8,25,26,59
141260507,14,126,5,7,4,8,91,103
141260508,14,126,5,8,88,97,44,229
141260509,14,126,5,9,92,116,96,304
141260510,14,126,5,10,100,90,29,219
141260511,14,126,5,11,95,122,20,237
141260512,14,126,5,12,158,119,70,347
141260513,14,126,5,13,45,34,58,137
141260514,14,126,5,14,56,85,52,193
141260515,14,126,5,15,28,59,31,118
141260516,14,126,5,16,77,77,48,202
141260517,14,126,5,17,70,52,23,145
141260518,14,126,5,18,12,41,70,123
141260601,14,126,6,1,6,30,28,64
141260602,14,126,6,2,1,7,18,26
141260603,14,126,6,3,37,41,33,111
141260604,14,126,6,4,29,61,17,107
141260605,14,126,6,5,31,49,44,124
141260606,14,126,6,6,0,2,5,7
141260607,14,126,6,7,45,48,40,133
141260608,14,126,6,8,103,77,3,183
141260609,14,126,6,9,82,72,5,159
141260610,14,126,6,10,58,74,44,176
141260611,14,126,6,11,11,18,6,35
141260701,14,126,7,1,88,61,3,152
141260702,14,126,7,2,113,82,16,211
141260703,14,126,7,3,121,37,0,158
141260704,14,126,7,4,67,80,52,199
141260705,14,126,7,5,164,81,5,250
141260706,14,126,7,6,155,53,3,211
141260707,14,126,7,7,122,65,3,190
141260708,14,126,7,8,131,103,13,247
141260709,14,126,7,9,139,48,4,191
141260710,14,126,7,10,59,59,17,135
141260711,14,126,7,11,75,99,14,188
141260712,14,126,7,12,128,113,14,255
141260713,14,126,7,13,48,35,5,88
141330101,14,133,1,1,0,2,19,21
141330102,14,133,1,2,19,30,49,98
141330103,14,133,1,3,23,35,65,123
141330104,14,133,1,4,12,39,66,117
141330105,14,133,1,5,50,68,147,265
141330106,14,133,1,6,4,5,14,23
141330107,14,133,1,7,11,23,6,40
141330108,14,133,1,8,23,41,144,208
141330109,14,133,1,9,23,25,32,80
141330110,14,133,1,10,84,75,99,258
141330111,14,133,1,11,51,54,205,310
141330112,14,133,1,12,22,49,157,228
141330201,14,133,2,1,44,82,34,160
141330202,14,133,2,2,14,29,30,73
141330203,14,133,2,3,17,24,19,60
141330204,14,133,2,4,72,76,116,264
141330205,14,133,2,5,10,14,45,69
141330206,14,133,2,6,9,29,34,72
141330207,14,133,2,7,44,60,16,120
141330208,14,133,2,8,126,59,16,201
141330209,14,133,2,9,63,40,9,112
141330210,14,133,2,10,18,33,10,61
141330211,14,133,2,11,85,81,12,178
141330212,14,133,2,12,90,65,15,170
141330213,14,133,2,13,168,138,31,337
141330214,14,133,2,14,87,81,34,202
141330215,14,133,2,15,22,26,7,55
141330216,14,133,2,16,86,61,32,179
141330301,14,133,3,1,13,22,44,79
141330302,14,133,3,2,34,44,45,123
141330303,14,133,3,3,7,16,42,65
141330304,14,133,3,4,13,28,95,136
141330305,14,133,3,5,13,33,72,118
141330306,14,133,3,6,10,27,55,92
141330307,14,133,3,7,142,156,32,330
141330308,14,133,3,8,25,47,51,123
141330309,14,133,3,9,47,77,84,208
141330401,14,133,4,1,4,3,17,24
141330402,14,133,4,2,3,1,40,44
141330403,14,133,4,3,4,2,40,46
141330404,14,133,4,4,14,14,32,60
141330405,14,133,4,5,24,33,70,127
141330406,14,133,4,6,11,3,40,54
141330407,14,133,4,7,9,10,50,69
141330408,14,133,4,8,32,41,55,128
141330409,14,133,4,9,195,116,45,356
141330410,14,133,4,10,61,52,19,132
141330411,14,133,4,11,46,67,58,171
141330501,14,133,5,1,136,119,53,308
141330502,14,133,5,2,127,75,6,208
141330503,14,133,5,3,119,79,12,210
141330504,14,133,5,4,110,52,39,201
141330505,14,133,5,5,55,78,101,234
141330506,14,133,5,6,186,97,16,299
141330507,14,133,5,7,186,56,8,250
141330508,14,133,5,8,204,21,16,241
141330509,14,133,5,9,194,28,4,226
141330510,14,133,5,10,229,86,25,340
141330511,14,133,5,11,131,87,20,238
141330512,14,133,5,12,93,127,93,313
141330513,14,133,5,13,170,55,16,241
141330514,14,133,5,14,90,27,3,120
141330515,14,133,5,15,189,124,36,349
141330516,14,133,5,16,146,65,32,243
141330517,14,133,5,17,97,88,34,219
141330601,14,133,6,1,199,80,2,281
141330602,14,133,6,2,263,104,18,385
141330603,14,133,6,3,180,84,11,275
141330604,14,133,6,4,145,75,16,236
141330605,14,133,6,5,106,72,70,248
141330606,14,133,6,6,99,44,30,173
141330607,14,133,6,7,59,56,155,270
141330608,14,133,6,8,112,89,30,231
141330609,14,133,6,9,182,53,1,236
141330610,14,133,6,10,176,90,4,270
141330611,14,133,6,11,96,73,18,187
141330612,14,133,6,12,94,49,16,159
141330613,14,133,6,13,190,104,12,306
141330614,14,133,6,14,129,132,29,290
141330615,14,133,6,15,123,87,14,224
141330616,14,133,6,16,144,63,24,231
141330617,14,133,6,17,162,26,7,195
141400101,14,140,1,1,7,18,13,38
141400102,14,140,1,2,7,23,7,37
141400103,14,140,1,3,30,57,14,101
141400104,14,140,1,4,17,12,10,39
141400105,14,140,1,5,4,18,7,29
141400106,14,140,1,6,4,12,1,17
141400107,14,140,1,7,9,12,5,26
141400108,14,140,1,8,10,19,16,45
141400109,14,140,1,9,155,126,7,288
141400110,14,140,1,10,67,100,14,181
141400111,14,140,1,11,102,106,24,232
141400112,14,140,1,12,93,143,7,243
141400113,14,140,1,13,2,29,32,63
141400201,14,140,2,1,7,23,8,38
141400202,14,140,2,2,51,26,20,97
141400203,14,140,2,3,5,34,10,49
141400204,14,140,2,4,29,40,20,89
141400205,14,140,2,5,10,14,6,30
141400206,14,140,2,6,36,39,7,82
141400207,14,140,2,7,3,8,13,24
141400208,14,140,2,8,21,24,14,59
141400209,14,140,2,9,15,16,13,44
141400210,14,140,2,10,3,12,8,23
141400211,14,140,2,11,55,105,13,173
141400212,14,140,2,12,135,75,16,226
141400213,14,140,2,13,20,76,0,96
141400301,14,140,3,1,127,184,24,335
141400302,14,140,3,2,157,214,13,384
141400303,14,140,3,3,96,115,3,214
141400304,14,140,3,4,78,116,6,200
141400305,14,140,3,5,95,206,6,307
141400306,14,140,3,6,123,137,9,269
141400307,14,140,3,7,136,124,11,271
141400308,14,140,3,8,170,136,19,325
141400309,14,140,3,9,100,99,8,207
141400310,14,140,3,10,117,145,7,269
141400311,14,140,3,11,116,104,4,224
141400312,14,140,3,12,169,80,0,249
141400313,14,140,3,13,78,44,2,124
141400401,14,140,4,1,104,106,4,214
141400402,14,140,4,2,122,101,5,228
141400403,14,140,4,3,134,47,0,181
141400404,14,140,4,4,173,29,2,204
141400405,14,140,4,5,112,96,3,211
141400406,14,140,4,6,113,124,3,240
141400407,14,140,4,7,177,149,2,328
141400408,14,140,4,8,122,162,28,312
141400409,14,140,4,9,121,203,24,348
141400410,14,140,4,10,139,79,9,227
141400411,14,140,4,11,73,97,7,177
141400412,14,140,4,12,112,183,11,306
141400413,14,140,4,13,107,147,16,270
141400501,14,140,5,1,20,30,17,67
141400502,14,140,5,2,18,57,10,85
141400503,14,140,5,3,2,26,7,35
141400504,14,140,5,4,14,18,9,41
141400505,14,140,5,5,14,28,12,54
141400506,14,140,5,6,12,32,6,50
141400507,14,140,5,7,1,1,8,10
141400508,14,140,5,8,123,158,26,307
141400509,14,140,5,9,107,164,13,284
141400510,14,140,5,10,25,68,4,97
141400511,14,140,5,11,127,114,71,312
141400512,14,140,5,12,81,126,12,219
141400513,14,140,5,13,72,103,18,193
141400514,14,140,5,14,183,81,11,275
141400515,14,140,5,15,107,143,12,262
141400516,14,140,5,16,119,124,25,268
141400517,14,140,5,17,84,64,38,186
141400518,14,140,5,18,70,89,29,188
141400519,14,140,5,19,109,77,13,199
141400520,14,140,5,20,171,156,41,368
141400601,14,140,6,1,6,5,2,13
141400602,14,140,6,2,9,10,9,28
141400603,14,140,6,3,6,6,7,19
141400604,14,140,6,4,24,19,42,85
141400605,14,140,6,5,10,38,15,63
141400606,14,140,6,6,16,16,14,46
141400607,14,140,6,7,9,17,16,42
141400608,14,140,6,8,13,21,9,43
141400609,14,140,6,9,11,4,10,25
141400610,14,140,6,10,140,198,31,369
141400611,14,140,6,11,157,70,8,235
141400612,14,140,6,12,56,80,57,193
141400613,14,140,6,13,42,47,23,112
141400614,14,140,6,14,109,110,26,245
141400615,14,140,6,15,70,64,11,145
141400616,14,140,6,16,175,174,16,365
141400617,14,140,6,17,138,41,4,183
141400618,14,140,6,18,60,121,3,184
141400619,14,140,6,19,143,138,39,320
141400701,14,140,7,1,93,123,22,238
141400702,14,140,7,2,151,171,12,334
141400703,14,140,7,3,157,81,1,239
141400704,14,140,7,4,97,94,3,194
141400705,14,140,7,5,113,188,58,359
141400706,14,140,7,6,157,152,45,354
141400707,14,140,7,7,169,22,1,192
141400708,14,140,7,8,116,53,5,174
141400709,14,140,7,9,123,74,19,216
141400710,14,140,7,10,100,169,73,342
141400711,14,140,7,11,132,175,16,323
141400712,14,140,7,12,147,64,1,212
141400713,14,140,7,13,197,94,34,325
141400714,14,140,7,14,98,156,22,276
141400715,14,140,7,15,212,29,28,269
141400716,14,140,7,16,214,74,22,310
141400717,14,140,7,17,62,29,25,116
141400718,14,140,7,18,226,103,15,344
141400719,14,140,7,19,209,69,7,285
141400720,14,140,7,20,119,105,48,272
141400801,14,140,8,1,42,52,63,157
141400802,14,140,8,2,19,41,34,94
141400803,14,140,8,3,31,61,45,137
141400804,14,140,8,4,58,44,71,173
141400805,14,140,8,5,21,23,18,62
141400806,14,140,8,6,8,26,4,38
141400807,14,140,8,7,22,29,23,74
141400808,14,140,8,8,19,32,24,75
141400809,14,140,8,9,74,154,55,283
141400810,14,140,8,10,42,100,96,238
141400811,14,140,8,11,46,118,39,203
141400812,14,140,8,12,178,152,9,339
141400813,14,140,8,13,117,127,13,257
141400814,14,140,8,14,113,90,5,208
141400815,14,140,8,15,49,165,25,239
141400816,14,140,8,16,118,105,15,238
141400817,14,140,8,17,121,130,10,261
141400818,14,140,8,18,155,118,25,298
141400819,14,140,8,19,100,129,30,259
141400820,14,140,8,20,203,131,7,341
141400821,14,140,8,21,84,67,25,176
141400901,14,140,9,1,14,23,26,63
141400902,14,140,9,2,7,8,14,29
141400903,14,140,9,3,22,18,28,68
141400904,14,140,9,4,45,42,42,129
141400905,14,140,9,5,18,19,17,54
141400906,14,140,9,6,36,25,21,82
141400907,14,140,9,7,9,25,4,38
141400908,14,140,9,8,70,160,41,271
141400909,14,140,9,9,96,173,19,288
141400910,14,140,9,10,78,145,22,245
141400911,14,140,9,11,130,199,12,341
141400912,14,140,9,12,92,110,4,206
141400913,14,140,9,13,154,113,2,269
141400914,14,140,9,14,63,180,50,293
141400915,14,140,9,15,208,150,9,367
141400916,14,140,9,16,72,82,25,179
141401001,14,140,10,1,26,16,27,69
141401002,14,140,10,2,19,21,26,66
141401003,14,140,10,3,24,24,18,66
141401004,14,140,10,4,11,17,17,45
141401005,14,140,10,5,9,20,10,39
141401006,14,140,10,6,64,20,22,106
141401007,14,140,10,7,28,25,18,71
141401008,14,140,10,8,94,71,14,179
141401009,14,140,10,9,76,124,15,215
141401010,14,140,10,10,163,85,19,267
141401011,14,140,10,11,124,119,17,260
141401012,14,140,10,12,217,123,17,357
141401013,14,140,10,13,112,41,3,156
141401014,14,140,10,14,127,74,7,208
141401015,14,140,10,15,142,126,9,277
141401016,14,140,10,16,192,136,9,337
141401017,14,140,10,17,118,123,31,272
141401101,14,140,11,1,112,22,2,136
141401102,14,140,11,2,139,72,1,212
141401103,14,140,11,3,195,155,1,351
141401104,14,140,11,4,147,60,1,208
141401105,14,140,11,5,178,103,5,286
141401106,14,140,11,6,80,109,1,190
141401107,14,140,11,7,142,60,5,207
141401108,14,140,11,8,174,270,4,448
141401109,14,140,11,9,56,183,0,239
141401110,14,140,11,10,154,123,4,281
141401111,14,140,11,11,141,94,1,236
141401112,14,140,11,12,91,122,0,213
141401113,14,140,11,13,142,137,4,283
141401114,14,140,11,14,168,84,2,254
141401115,14,140,11,15,132,64,0,196
141401116,14,140,11,16,137,56,0,193
141401117,14,140,11,17,125,56,1,182
141401118,14,140,11,18,270,53,0,323
141401119,14,140,11,19,235,69,1,305
141401120,14,140,11,20,257,90,1,348
141401121,14,140,11,21,228,100,0,328
141401201,14,140,12,1,134,47,17,198
141401202,14,140,12,2,101,67,4,172
141401203,14,140,12,3,71,84,80,235
141401204,14,140,12,4,71,128,28,227
141401205,14,140,12,5,111,203,16,330
141401206,14,140,12,6,95,166,72,333
141401207,14,140,12,7,172,109,5,286
141401208,14,140,12,8,137,124,6,267
141401209,14,140,12,9,136,115,4,255
141401210,14,140,12,10,111,163,49,323
141401211,14,140,12,11,140,192,21,353
141401212,14,140,12,12,100,166,30,296
141401213,14,140,12,13,153,92,8,253
141401214,14,140,12,14,105,98,6,209
141401215,14,140,12,15,126,88,3,217
141401216,14,140,12,16,155,47,2,204
141401217,14,140,12,17,187,80,0,267
141401218,14,140,12,18,122,63,2,187
141401219,14,140,12,19,95,89,33,217
141401301,14,140,13,1,157,50,2,209
141401302,14,140,13,2,175,42,0,217
141401303,14,140,13,3,134,63,1,198
141401304,14,140,13,4,86,157,2,245
141401305,14,140,13,5,125,131,11,267
141401306,14,140,13,6,159,78,1,238
141401307,14,140,13,7,161,27,0,188
141401308,14,140,13,8,110,61,0,171
141401309,14,140,13,9,125,108,0,233
141401310,14,140,13,10,164,56,2,222
141401311,14,140,13,11,97,140,2,239
141401312,14,140,13,12,139,73,11,223
141401313,14,140,13,13,91,180,10,281
141401314,14,140,13,14,116,82,2,200
141401315,14,140,13,15,121,139,44,304
141401316,14,140,13,16,105,145,9,259
141401317,14,140,13,17,83,140,85,308
141401318,14,140,13,18,71,89,67,227
141401401,14,140,14,1,150,154,8,312
141401402,14,140,14,2,125,120,7,252
141401403,14,140,14,3,148,82,2,232
141401404,14,140,14,4,151,107,3,261
141401405,14,140,14,5,173,79,25,277
141401406,14,140,14,6,128,56,1,185
141401407,14,140,14,7,172,55,1,228
141401408,14,140,14,8,93,54,2,149
141401409,14,140,14,9,131,43,3,177
141401410,14,140,14,10,100,71,7,178
141401411,14,140,14,11,132,99,5,236
141401412,14,140,14,12,162,141,4,307
141401413,14,140,14,13,291,86,0,377
141401414,14,140,14,14,138,246,2,386
141401415,14,140,14,15,154,150,2,306
141401416,14,140,14,16,114,189,2,305
141401417,14,140,14,17,106,134,11,251
141401418,14,140,14,18,110,175,8,293
141401419,14,140,14,19,97,162,6,265
141401420,14,140,14,20,104,88,6,198
141401421,14,140,14,21,94,98,24,216
141401422,14,140,14,22,100,82,7,189
141401423,14,140,14,23,108,132,11,251
141401501,14,140,15,1,15,35,23,73
141401502,14,140,15,2,23,14,18,55
141401503,14,140,15,3,15,19,30,64
141401504,14,140,15,4,31,18,25,74
141401505,14,140,15,5,25,19,33,77
141401506,14,140,15,6,21,11,17,49
141401507,14,140,15,7,118,78,20,216
141401508,14,140,15,8,84,73,13,170
141401509,14,140,15,9,129,103,11,243
141401510,14,140,15,10,195,89,16,300
141401511,14,140,15,11,159,106,9,274
141401512,14,140,15,12,187,142,0,329
141401513,14,140,15,13,142,210,69,421
141401514,14,140,15,14,40,55,15,110
141401515,14,140,15,15,38,47,12,97
141401601,14,140,16,1,15,11,11,37
141401602,14,140,16,2,22,6,28,56
141401603,14,140,16,3,11,19,18,48
141401604,14,140,16,4,3,4,4,11
141401605,14,140,16,5,37,29,18,84
141401606,14,140,16,6,33,30,12,75
141401607,14,140,16,7,155,43,9,207
141401608,14,140,16,8,169,142,43,354
141401609,14,140,16,9,73,155,11,239
141401610,14,140,16,10,127,184,36,347
141401611,14,140,16,11,165,170,8,343
141401612,14,140,16,12,95,118,12,225
141401613,14,140,16,13,104,73,9,186
141401614,14,140,16,14,217,36,7,260
141401615,14,140,16,15,156,38,10,204
141401701,14,140,17,1,15,19,22,56
141401702,14,140,17,2,19,17,24,60
141401703,14,140,17,3,9,7,22,38
141401704,14,140,17,4,13,4,6,23
141401705,14,140,17,5,27,29,25,81
141401706,14,140,17,6,19,15,15,49
141401707,14,140,17,7,5,9,6,20
141401708,14,140,17,8,32,21,16,69
141401709,14,140,17,9,20,49,32,101
141401710,14,140,17,10,31,21,12,64
141401711,14,140,17,11,123,183,38,344
141401712,14,140,17,12,106,93,1,200
141401713,14,140,17,13,81,88,0,169
141401714,14,140,17,14,253,100,6,359
141401715,14,140,17,15,112,130,22,264
141401716,14,140,17,16,98,106,4,208
141401717,14,140,17,17,107,120,21,248
141401718,14,140,17,18,8,21,34,63
141401719,14,140,17,19,120,84,41,245
141401720,14,140,17,20,85,102,7,194
141401801,14,140,18,1,71,140,5,216
141401802,14,140,18,2,79,129,34,242
141401803,14,140,18,3,134,87,6,227
141401804,14,140,18,4,102,109,7,218
141401805,14,140,18,5,73,81,70,224
141401806,14,140,18,6,142,63,38,243
141401807,14,140,18,7,101,101,2,204
141401808,14,140,18,8,126,144,20,290
141401809,14,140,18,9,144,122,1,267
141401810,14,140,18,10,94,115,1,210
141401811,14,140,18,11,122,125,2,249
141401812,14,140,18,12,102,116,9,227
141401901,14,140,19,1,169,152,34,355
141401902,14,140,19,2,131,86,3,220
141401903,14,140,19,3,108,54,1,163
141401904,14,140,19,4,115,66,1,182
141401905,14,140,19,5,82,52,3,137
141401906,14,140,19,6,127,81,8,216
141401907,14,140,19,7,119,75,7,201
141401908,14,140,19,8,98,101,6,205
141401909,14,140,19,9,92,156,9,257
141401910,14,140,19,10,153,237,9,399
141401911,14,140,19,11,58,157,2,217
141470101,14,147,1,1,11,10,6,27
141470102,14,147,1,2,66,69,37,172
141470103,14,147,1,3,22,35,111,168
141470104,14,147,1,4,103,127,79,309
141470105,14,147,1,5,170,156,16,342
141470106,14,147,1,6,122,93,16,231
141470107,14,147,1,7,95,129,44,268
141470108,14,147,1,8,76,72,0,148
141470109,14,147,1,9,114,219,20,353
141470110,14,147,1,10,144,154,46,344
141470111,14,147,1,11,105,140,15,260
141470112,14,147,1,12,151,76,7,234
141470113,14,147,1,13,117,64,17,198
141470114,14,147,1,14,118,102,57,277
141470201,14,147,2,1,62,62,31,155
141470202,14,147,2,2,166,181,104,451
141470203,14,147,2,3,6,4,39,49
141470204,14,147,2,4,85,51,69,205
141470205,14,147,2,5,41,70,166,277
141470206,14,147,2,6,23,11,23,57
141470207,14,147,2,7,116,123,46,285
141470208,14,147,2,8,77,131,29,237
141470209,14,147,2,9,88,96,26,210
141470210,14,147,2,10,136,173,27,336
141470211,14,147,2,11,91,115,17,223
141470212,14,147,2,12,69,102,29,200
141470213,14,147,2,13,46,98,46,190
141470301,14,147,3,1,5,4,20,29
141470302,14,147,3,2,17,15,12,44
141470303,14,147,3,3,56,30,40,126
141470304,14,147,3,4,49,47,25,121
141470305,14,147,3,5,38,14,27,79
141470306,14,147,3,6,12,7,4,23
141470307,14,147,3,7,36,41,67,144
141470308,14,147,3,8,54,98,168,320
141470309,14,147,3,9,142,78,26,246
141470310,14,147,3,10,139,98,50,287
141470311,14,147,3,11,89,53,42,184
141470312,14,147,3,12,74,43,24,141
141470313,14,147,3,13,84,31,0,115
141470314,14,147,3,14,84,34,6,124
141470401,14,147,4,1,19,14,20,53
141470402,14,147,4,2,13,12,14,39
141470403,14,147,4,3,16,16,28,60
141470404,14,147,4,4,4,5,3,12
141470405,14,147,4,5,91,50,25,166
141470406,14,147,4,6,42,49,47,138
141470407,14,147,4,7,166,134,9,309
141470408,14,147,4,8,172,115,43,330
141470409,14,147,4,9,46,120,9,175
141470410,14,147,4,10,105,94,29,228
141470411,14,147,4,11,105,114,19,238
141470412,14,147,4,12,139,146,57,342
141470413,14,147,4,13,53,77,43,173
141470501,14,147,5,1,10,8,12,30
141470502,14,147,5,2,9,8,11,28
141470503,14,147,5,3,9,22,12,43
141470504,14,147,5,4,20,11,18,49
141470505,14,147,5,5,10,8,3,21
141470506,14,147,5,6,5,5,1,11
141470507,14,147,5,7,51,48,7,106
141470508,14,147,5,8,125,62,8,195
141470601,14,147,6,1,46,46,37,129
141470602,14,147,6,2,26,33,11,70
141470603,14,147,6,3,96,30,6,132
141470604,14,147,6,4,82,29,1,112
141470605,14,147,6,5,67,16,6,89
141470606,14,147,6,6,69,64,17,150
141470607,14,147,6,7,71,45,4,120
141470608,14,147,6,8,88,45,21,154
141470609,14,147,6,9,74,26,10,110
141470610,14,147,6,10,68,71,19,158
141470701,14,147,7,1,10,12,5,27
141470702,14,147,7,2,2,5,5,12
141470703,14,147,7,3,2,4,11,17
141470704,14,147,7,4,9,20,18,47
141470705,14,147,7,5,0,1,1,2
141470706,14,147,7,6,0,12,13,25
141470707,14,147,7,7,9,4,17,30
141470708,14,147,7,8,20,11,4,35
141470709,14,147,7,9,30,22,7,59
141470710,14,147,7,10,42,27,26,95
141470711,14,147,7,11,49,34,7,90
141470712,14,147,7,12,29,23,9,61
141470713,14,147,7,13,16,14,15,45
141470714,14,147,7,14,60,58,32,150
141470801,14,147,8,1,209,40,8,257
141470802,14,147,8,2,176,94,44,314
141470803,14,147,8,3,162,109,60,331
141470804,14,147,8,4,107,106,15,228
141470805,14,147,8,5,253,151,55,459
141470806,14,147,8,6,242,129,7,378
141470807,14,147,8,7,160,105,20,285
141470808,14,147,8,8,227,45,2,274
141470809,14,147,8,9,196,53,3,252
141470810,14,147,8,10,138,30,0,168
141470811,14,147,8,11,163,62,3,228
141470812,14,147,8,12,155,122,50,327
141470813,14,147,8,13,185,71,0,256
141470814,14,147,8,14,183,61,0,244
141470815,14,147,8,15,166,55,1,222
141470816,14,147,8,16,169,33,0,202
141470817,14,147,8,17,90,32,0,122
141470901,14,147,9,1,76,120,95,291
141470902,14,147,9,2,133,126,111,370
141470903,14,147,9,3,184,139,57,380
141470904,14,147,9,4,86,98,18,202
141470905,14,147,9,5,139,53,25,217
141470906,14,147,9,6,185,122,14,321
141470907,14,147,9,7,129,40,0,169
141470908,14,147,9,8,161,100,32,293
141470909,14,147,9,9,142,64,1,207
141470910,14,147,9,10,135,54,10,199
141470911,14,147,9,11,140,43,5,188
141470912,14,147,9,12,178,129,32,339
141470913,14,147,9,13,193,175,8,376
141470914,14,147,9,14,168,64,4,236
141470915,14,147,9,15,166,87,5,258
141470916,14,147,9,16,117,108,4,229
141470917,14,147,9,17,116,59,8,183
141470918,14,147,9,18,47,93,64,204
141470919,14,147,9,19,74,131,57,262
141471001,14,147,10,1,156,57,3,216
141471002,14,147,10,2,199,60,9,268
141471003,14,147,10,3,138,40,2,180
141471004,14,147,10,4,150,63,6,219
141471005,14,147,10,5,230,82,3,315
141471006,14,147,10,6,173,44,2,219
141471007,14,147,10,7,152,68,1,221
141471008,14,147,10,8,220,103,27,350
141471009,14,147,10,9,180,49,19,248
141471010,14,147,10,10,228,143,3,374
141471011,14,147,10,11,144,194,83,421
141471012,14,147,10,12,86,84,88,258
141471013,14,147,10,13,129,86,69,284
141471014,14,147,10,14,186,167,46,399
141471015,14,147,10,15,119,148,143,410
141540101,14,154,1,1,0,1,30,31
141540102,14,154,1,2,5,12,22,39
141540103,14,154,1,3,9,29,59,97
141540104,14,154,1,4,11,21,48,80
141540105,14,154,1,5,2,6,13,21
141540106,14,154,1,6,0,3,3,6
141540107,14,154,1,7,2,10,20,32
141540201,14,154,2,1,3,3,41,47
141540202,14,154,2,2,0,4,1,5
141540203,14,154,2,3,0,8,19,27
141540204,14,154,2,4,22,17,14,53
141540205,14,154,2,5,2,15,11,28
141540206,14,154,2,6,10,8,6,24
141540207,14,154,2,7,3,7,22,32
141540208,14,154,2,8,0,11,25,36
141540209,14,154,2,9,38,70,44,152
141540210,14,154,2,10,43,89,37,169
141540211,14,154,2,11,113,127,24,264
141540212,14,154,2,12,16,65,9,90
141610101,14,161,1,1,12,8,8,28
141610102,14,161,1,2,7,22,6,35
141610103,14,161,1,3,13,25,9,47
141610104,14,161,1,4,24,30,12,66
141610105,14,161,1,5,10,26,23,59
141610106,14,161,1,6,9,14,1,24
141610107,14,161,1,7,19,9,3,31
141610108,14,161,1,8,13,16,1,30
141610109,14,161,1,9,14,20,3,37
141610110,14,161,1,10,18,25,18,61
141610111,14,161,1,11,3,28,6,37
141610112,14,161,1,12,52,123,65,240
141610113,14,161,1,13,157,123,13,293
141610114,14,161,1,14,63,97,5,165
141610115,14,161,1,15,50,101,4,155
141610116,14,161,1,16,99,149,8,256
141610117,14,161,1,17,121,180,26,327
141610201,14,161,2,1,13,32,3,48
141610202,14,161,2,2,16,21,7,44
141610203,14,161,2,3,10,11,0,21
141610204,14,161,2,4,5,14,2,21
141610205,14,161,2,5,6,10,3,19
141610206,14,161,2,6,8,24,3,35
141610207,14,161,2,7,37,162,7,206
141610208,14,161,2,8,120,109,7,236
141610209,14,161,2,9,152,119,2,273
141610210,14,161,2,10,83,124,1,208
141610211,14,161,2,11,125,99,10,234
141610212,14,161,2,12,107,71,17,195
141610213,14,161,2,13,67,138,9,214
141610214,14,161,2,14,57,164,5,226
141610215,14,161,2,15,103,96,9,208
141610216,14,161,2,16,102,99,22,223
141610301,14,161,3,1,30,45,17,92
141610302,14,161,3,2,17,21,2,40
141610303,14,161,3,3,24,13,5,42
141610304,14,161,3,4,26,26,10,62
141610305,14,161,3,5,20,68,28,116
141610306,14,161,3,6,130,67,43,240
141610307,14,161,3,7,94,209,18,321
141610308,14,161,3,8,113,73,7,193
141610309,14,161,3,9,50,114,27,191
141610310,14,161,3,10,148,149,8,305
141610311,14,161,3,11,116,59,2,177
141610312,14,161,3,12,75,71,3,149
141610313,14,161,3,13,81,73,9,163
141610401,14,161,4,1,16,30,6,52
141610402,14,161,4,2,15,13,5,33
141610403,14,161,4,3,6,14,4,24
141610404,14,161,4,4,1,30,1,32
141610405,14,161,4,5,23,33,9,65
141610406,14,161,4,6,13,33,5,51
141610407,14,161,4,7,13,56,14,83
141610408,14,161,4,8,5,10,2,17
141610409,14,161,4,9,20,26,5,51
141610410,14,161,4,10,14,31,10,55
141610411,14,161,4,11,33,50,6,89
141610412,14,161,4,12,99,122,20,241
141610413,14,161,4,13,92,128,8,228
141610501,14,161,5,1,16,8,0,24
141610502,14,161,5,2,14,9,1,24
141610503,14,161,5,3,21,48,19,88
141610504,14,161,5,4,14,8,2,24
141610505,14,161,5,5,12,32,3,47
141610506,14,161,5,6,35,148,41,224
141610507,14,161,5,7,177,141,18,336
141610508,14,161,5,8,142,43,2,187
141610509,14,161,5,9,125,82,4,211
141610510,14,161,5,10,107,94,0,201
141610511,14,161,5,11,111,114,3,228
141610512,14,161,5,12,62,127,6,195
141610601,14,161,6,1,57,115,31,203
141610602,14,161,6,2,73,138,5,216
141610603,14,161,6,3,143,186,5,334
141610604,14,161,6,4,181,105,9,295
141610605,14,161,6,5,85,87,7,179
141610606,14,161,6,6,107,201,9,317
141610607,14,161,6,7,61,199,5,265
141610608,14,161,6,8,139,59,4,202
141610609,14,161,6,9,109,101,12,222
141610610,14,161,6,10,124,122,4,250
141610611,14,161,6,11,171,47,2,220
141610612,14,161,6,12,176,74,3,253
141610613,14,161,6,13,106,139,20,265
141610614,14,161,6,14,80,94,30,204
141610701,14,161,7,1,95,144,1,240
141610702,14,161,7,2,67,104,2,173
141610703,14,161,7,3,207,103,0,310
141610704,14,161,7,4,68,73,2,143
141610705,14,161,7,5,81,65,1,147
141610706,14,161,7,6,71,189,9,269
141610707,14,161,7,7,102,106,5,213
141610708,14,161,7,8,82,186,24,292
141610709,14,161,7,9,175,125,3,303
141610710,14,161,7,10,109,130,1,240
141610711,14,161,7,11,100,97,1,198
141610712,14,161,7,12,101,222,27,350
141610713,14,161,7,13,90,203,6,299
141610714,14,161,7,14,53,173,20,246
141610715,14,161,7,15,200,156,20,376
141610801,14,161,8,1,80,133,0,213
141610802,14,161,8,2,76,34,10,120
141610803,14,161,8,3,131,49,8,188
141610804,14,161,8,4,80,99,2,181
141610805,14,161,8,5,129,28,2,159
141610806,14,161,8,6,75,91,9,175
141610807,14,161,8,7,113,151,17,281
141610808,14,161,8,8,132,68,4,204
141610809,14,161,8,9,78,90,4,172
141610810,14,161,8,10,158,137,5,300
141610811,14,161,8,11,54,122,5,181
141610812,14,161,8,12,148,39,1,188
141610813,14,161,8,13,120,69,5,194
141610814,14,161,8,14,133,122,2,257
141610815,14,161,8,15,87,96,27,210
141610816,14,161,8,16,117,70,5,192
141610817,14,161,8,17,173,137,7,317
141610901,14,161,9,1,56,121,36,213
141610902,14,161,9,2,91,168,28,287
141610903,14,161,9,3,115,116,24,255
141610904,14,161,9,4,46,161,30,237
141610905,14,161,9,5,92,151,15,258
141610906,14,161,9,6,50,190,38,278
141610907,14,161,9,7,149,83,2,234
141610908,14,161,9,8,69,142,0,211
141610909,14,161,9,9,84,144,8,236
141610910,14,161,9,10,90,116,2,208
141610911,14,161,9,11,157,109,0,266
141610912,14,161,9,12,207,32,1,240
141610913,14,161,9,13,131,139,0,270
141610914,14,161,9,14,134,78,2,214
141610915,14,161,9,15,178,128,2,308
141610916,14,161,9,16,112,84,1,197
141610917,14,161,9,17,110,104,0,214
141610918,14,161,9,18,148,183,0,331
141610919,14,161,9,19,126,106,1,233
141610920,14,161,9,20,121,84,8,213
141610921,14,161,9,21,128,202,4,334
141610922,14,161,9,22,65,218,0,283
141610923,14,161,9,23,81,134,4,219
141611001,14,161,10,1,133,103,0,236
141611002,14,161,10,2,87,182,1,270
141611003,14,161,10,3,146,109,0,255
141611004,14,161,10,4,151,78,6,235
141611005,14,161,10,5,154,73,2,229
141611006,14,161,10,6,153,126,1,280
141611007,14,161,10,7,103,240,4,347
141611008,14,161,10,8,99,139,3,241
141611009,14,161,10,9,72,128,2,202
141611010,14,161,10,10,81,92,0,173
141611011,14,161,10,11,103,82,0,185
141611012,14,161,10,12,169,153,0,322
141611013,14,161,10,13,103,98,1,202
141611014,14,161,10,14,110,96,1,207
141611015,14,161,10,15,139,51,2,192
141611016,14,161,10,16,88,148,3,239
141611017,14,161,10,17,151,190,7,348
141611018,14,161,10,18,118,165,1,284
141611019,14,161,10,19,172,114,0,286
141611020,14,161,10,20,66,172,10,248
141611021,14,161,10,21,132,101,5,238
141611101,14,161,11,1,126,208,27,361
141611102,14,161,11,2,48,149,10,207
141611103,14,161,11,3,40,114,12,166
141611104,14,161,11,4,130,156,13,299
141611105,14,161,11,5,122,91,5,218
141611106,14,161,11,6,129,113,2,244
141611107,14,161,11,7,97,121,1,219
141611108,14,161,11,8,126,63,8,197
141611109,14,161,11,9,60,90,13,163
141611110,14,161,11,10,35,151,32,218
141611111,14,161,11,11,128,222,9,359
141611112,14,161,11,12,147,164,2,313
141611113,14,161,11,13,95,161,1,257
141611114,14,161,11,14,101,133,5,239
141611115,14,161,11,15,89,126,4,219
141611116,14,161,11,16,93,200,12,305
141611117,14,161,11,17,111,89,20,220
141680101,14,168,1,1,2,7,37,46
141680102,14,168,1,2,11,9,32,52
141680103,14,168,1,3,7,14,5,26
141680104,14,168,1,4,2,5,8,15
141680105,14,168,1,5,2,7,8,17
141680106,14,168,1,6,7,27,11,45
141680107,14,168,1,7,12,14,9,35
141680108,14,168,1,8,7,47,35,89
141680109,14,168,1,9,4,15,7,26
141680110,14,168,1,10,12,67,18,97
141680111,14,168,1,11,39,122,42,203
141680112,14,168,1,12,96,158,13,267
141680113,14,168,1,13,44,44,54,142
141680114,14,168,1,14,70,141,91,302
141680201,14,168,2,1,11,23,12,46
141680202,14,168,2,2,41,27,14,82
141680203,14,168,2,3,2,16,7,25
141680204,14,168,2,4,60,84,13,157
141680205,14,168,2,5,82,60,11,153
141680206,14,168,2,6,63,110,17,190
141680207,14,168,2,7,101,138,17,256
141680208,14,168,2,8,143,127,12,282
141680209,14,168,2,9,61,120,26,207
141680210,14,168,2,10,84,96,12,192
141680211,14,168,2,11,106,135,7,248
141680212,14,168,2,12,84,77,72,233
141680213,14,168,2,13,87,116,15,218
141680214,14,168,2,14,92,85,12,189
141680301,14,168,3,1,4,13,10,27
141680302,14,168,3,2,16,24,21,61
141680303,14,168,3,3,30,39,25,94
141680304,14,168,3,4,6,22,4,32
141680305,14,168,3,5,14,29,14,57
141680306,14,168,3,6,3,19,4,26
141680307,14,168,3,7,10,31,11,52
141680308,14,168,3,8,5,3,11,19
141680309,14,168,3,9,2,35,14,51
141680310,14,168,3,10,19,15,19,53
141680311,14,168,3,11,135,137,39,311
141680312,14,168,3,12,54,102,62,218
141680313,14,168,3,13,92,186,23,301
141750101,14,175,1,1,2,0,33,35
141750102,14,175,1,2,2,5,20,27
141750103,14,175,1,3,3,16,34,53
141750104,14,175,1,4,3,14,10,27
141750105,14,175,1,5,1,16,37,54
141750106,14,175,1,6,3,13,6,22
141750107,14,175,1,7,1,15,60,76
141750108,14,175,1,8,13,6,23,42
141750109,14,175,1,9,7,3,40,50
141750110,14,175,1,10,9,57,161,227
141750111,14,175,1,11,32,69,83,184
141750112,14,175,1,12,38,42,22,102
141750113,14,175,1,13,92,96,30,218
141750114,14,175,1,14,100,101,28,229
141750201,14,175,2,1,3,12,140,155
141750202,14,175,2,2,21,43,87,151
141750203,14,175,2,3,7,28,29,64
141750204,14,175,2,4,1,14,73,88
141750205,14,175,2,5,2,12,30,44
141750206,14,175,2,6,9,17,35,61
141750207,14,175,2,7,9,9,14,32
141750208,14,175,2,8,4,13,49,66
141750209,14,175,2,9,15,45,78,138
141750210,14,175,2,10,1,11,42,54
141750211,14,175,2,11,12,21,31,64
141750212,14,175,2,12,38,148,23,209
141750213,14,175,2,13,56,155,36,247
141750214,14,175,2,14,78,119,47,244
141750215,14,175,2,15,49,173,31,253
141750216,14,175,2,16,79,98,13,190
141750217,14,175,2,17,115,72,13,200
141750218,14,175,2,18,87,165,85,337
141750219,14,175,2,19,0,0,1,1
141820101,14,182,1,1,16,23,9,48
141820102,14,182,1,2,27,22,4,53
141820103,14,182,1,3,12,27,6,45
141820104,14,182,1,4,24,10,7,41
141820105,14,182,1,5,29,16,12,57
141820106,14,182,1,6,30,34,21,85
141820107,14,182,1,7,37,27,6,70
141820108,14,182,1,8,31,34,12,77
141820109,14,182,1,9,28,11,7,46
141820110,14,182,1,10,24,71,27,122
141820111,14,182,1,11,89,98,3,190
141820112,14,182,1,12,94,127,7,228
141820113,14,182,1,13,116,118,16,250
141820114,14,182,1,14,56,64,26,146
141820115,14,182,1,15,74,75,39,188
141820116,14,182,1,16,96,184,54,334
141820117,14,182,1,17,48,130,40,218
141820118,14,182,1,18,147,100,15,262
141820119,14,182,1,19,168,114,6,288
141820120,14,182,1,20,116,199,3,318
141820121,14,182,1,21,124,89,5,218
141820201,14,182,2,1,14,36,11,61
141820202,14,182,2,2,20,66,20,106
141820203,14,182,2,3,41,37,10,88
141820204,14,182,2,4,16,12,9,37
141820205,14,182,2,5,14,13,4,31
141820206,14,182,2,6,148,80,17,245
141820207,14,182,2,7,142,87,3,232
141820208,14,182,2,8,89,86,19,194
141820209,14,182,2,9,87,148,30,265
141820210,14,182,2,10,112,112,40,264
141820211,14,182,2,11,92,122,53,267
141820212,14,182,2,12,36,73,56,165
141820213,14,182,2,13,166,143,14,323
141820214,14,182,2,14,88,58,18,164
141820301,14,182,3,1,27,21,10,58
141820302,14,182,3,2,5,4,9,18
141820303,14,182,3,3,39,17,13,69
141820304,14,182,3,4,20,14,7,41
141820305,14,182,3,5,15,11,4,30
141820306,14,182,3,6,27,25,3,55
141820307,14,182,3,7,197,105,6,308
141820308,14,182,3,8,117,80,32,229
141820309,14,182,3,9,99,72,3,174
141820310,14,182,3,10,139,150,81,370
141820401,14,182,4,1,19,11,5,35
141820402,14,182,4,2,43,33,33,109
141820403,14,182,4,3,37,29,13,79
141820404,14,182,4,4,17,11,3,31
141820405,14,182,4,5,15,14,5,34
141820406,14,182,4,6,40,14,4,58
141820407,14,182,4,7,32,2,6,40
141820408,14,182,4,8,35,49,28,112
141820409,14,182,4,9,111,122,8,241
141820410,14,182,4,10,142,77,1,220
141820411,14,182,4,11,173,135,15,323
141820412,14,182,4,12,60,106,46,212
141820413,14,182,4,13,112,145,22,279
141820414,14,182,4,14,108,95,5,208
141820415,14,182,4,15,197,97,22,316
141820501,14,182,5,1,13,9,4,26
141820502,14,182,5,2,15,7,5,27
141820503,14,182,5,3,3,3,2,8
141820504,14,182,5,4,10,7,3,20
141820505,14,182,5,5,33,20,12,65
141820506,14,182,5,6,12,6,6,24
141820507,14,182,5,7,3,9,3,15
141820508,14,182,5,8,16,10,6,32
141820509,14,182,5,9,102,88,10,200
141820510,14,182,5,10,108,49,7,164
141820511,14,182,5,11,171,122,12,305
141820512,14,182,5,12,116,72,50,238
141820513,14,182,5,13,98,113,15,226
141820514,14,182,5,14,133,66,7,206
141820515,14,182,5,15,125,125,7,257
141820516,14,182,5,16,83,100,43,226
141820517,14,182,5,17,97,46,19,162
141820518,14,182,5,18,225,132,13,370
141820519,14,182,5,19,85,61,5,151
141820520,14,182,5,20,126,84,8,218
141820521,14,182,5,21,98,93,27,218
141820601,14,182,6,1,13,8,6,27
141820602,14,182,6,2,20,21,5,46
141820603,14,182,6,3,16,9,2,27
141820604,14,182,6,4,7,13,16,36
141820605,14,182,6,5,15,21,5,41
141820606,14,182,6,6,2,3,1,6
141820607,14,182,6,7,190,116,23,329
141820608,14,182,6,8,114,71,18,203
141820609,14,182,6,9,191,216,7,414
141820610,14,182,6,10,121,107,18,246
141820611,14,182,6,11,155,44,2,201
141820612,14,182,6,12,139,132,33,304
141820613,14,182,6,13,158,61,6,225
141820614,14,182,6,14,97,35,4,136
141820615,14,182,6,15,204,87,18,309
141820616,14,182,6,16,126,64,12,202
141820617,14,182,6,17,144,54,11,209
141820618,14,182,6,18,89,32,2,123
141820619,14,182,6,19,56,29,28,113
141820701,14,182,7,1,12,11,2,25
141820702,14,182,7,2,32,24,20,76
141820703,14,182,7,3,22,14,10,46
141820704,14,182,7,4,11,12,3,26
141820705,14,182,7,5,20,16,12,48
141820706,14,182,7,6,19,14,2,35
141820707,14,182,7,7,61,44,18,123
141820708,14,182,7,8,13,17,20,50
141820709,14,182,7,9,22,16,7,45
141820710,14,182,7,10,14,25,2,41
141820711,14,182,7,11,61,96,69,226
141820712,14,182,7,12,74,37,21,132
141820713,14,182,7,13,76,91,12,179
141820714,14,182,7,14,119,87,8,214
141820715,14,182,7,15,204,86,20,310
141820716,14,182,7,16,151,82,12,245
141820801,14,182,8,1,71,78,61,210
141820802,14,182,8,2,166,43,20,229
141820803,14,182,8,3,109,147,12,268
141820804,14,182,8,4,89,128,5,222
141820805,14,182,8,5,198,118,3,319
141820806,14,182,8,6,155,138,21,314
141820807,14,182,8,7,168,40,0,208
141820808,14,182,8,8,131,46,0,177
141820809,14,182,8,9,223,107,1,331
141820810,14,182,8,10,209,101,3,313
141820811,14,182,8,11,156,55,2,213
141820812,14,182,8,12,87,43,0,130
141820901,14,182,9,1,202,77,11,290
141820902,14,182,9,2,128,171,29,328
141820903,14,182,9,3,89,140,46,275
141820904,14,182,9,4,96,109,21,226
141820905,14,182,9,5,116,81,17,214
141820906,14,182,9,6,181,55,2,238
141820907,14,182,9,7,142,72,10,224
141820908,14,182,9,8,174,134,48,356
141820909,14,182,9,9,96,155,51,302
141820910,14,182,9,10,206,133,14,353
141820911,14,182,9,11,222,76,2,300
141821001,14,182,10,1,130,84,1,215
141821002,14,182,10,2,185,116,3,304
141821003,14,182,10,3,68,120,5,193
141821004,14,182,10,4,123,112,48,283
141821005,14,182,10,5,49,60,45,154
141821006,14,182,10,6,76,116,14,206
141821007,14,182,10,7,214,59,5,278
141821008,14,182,10,8,86,88,2,176
141821009,14,182,10,9,123,143,13,279
141821010,14,182,10,10,63,177,64,304
141821101,14,182,11,1,116,28,2,146
141821102,14,182,11,2,194,39,1,234
141821103,14,182,11,3,113,45,0,158
141821104,14,182,11,4,199,23,0,222
141821105,14,182,11,5,124,63,2,189
141821106,14,182,11,6,128,115,13,256
141821107,14,182,11,7,79,106,4,189
141821108,14,182,11,8,100,125,20,245
141821109,14,182,11,9,121,150,109,380
141821110,14,182,11,10,192,131,23,346
141821201,14,182,12,1,132,77,3,212
141821202,14,182,12,2,94,81,8,183
141821203,14,182,12,3,182,90,0,272
141821204,14,182,12,4,117,184,21,322
141821205,14,182,12,5,110,115,5,230
141821206,14,182,12,6,178,130,15,323
141821207,14,182,12,7,138,138,4,280
141821208,14,182,12,8,139,60,4,203
141821209,14,182,12,9,91,88,14,193
141821210,14,182,12,10,98,102,0,200
141821211,14,182,12,11,127,96,21,244
141821301,14,182,13,1,185,93,37,315
141821302,14,182,13,2,177,100,20,297
141821303,14,182,13,3,148,83,1,232
141821304,14,182,13,4,192,84,8,284
141821305,14,182,13,5,126,72,3,201
141821306,14,182,13,6,183,41,22,246
141821307,14,182,13,7,144,107,29,280
141821308,14,182,13,8,8,31,74,113
141821309,14,182,13,9,82,72,7,161
141821310,14,182,13,10,107,58,15,180
141821311,14,182,13,11,106,98,37,241
141821312,14,182,13,12,127,57,63,247
